You've planned a wonderful camping trip with your girlfriend. She's depending on you to make the experience memorable, but everything keeps going wrong for you.

An Experience
The Beginning by Kapri Lisehora
Release 1 / Serial number 130303 / Inform 7 build 6G60 (I6/v6.32 lib 6/12N) SD

Campfire
It's night, but the fire just burned out and you both are getting cold. Your tent is in a grassy clearing. To the north are the woods, to the east a stream, and the west a rocky cliff. A mysterious cabin is to your south. In your tent there's a cooler, a backpack, and two sleeping bags.

You can see a cooler (closed), a backpack (closed) and sleeping bags here.

>gonear flower vendor
Flower Vendor
Mr. Florence has run the vending cart for as long as you've lived here.

>x mr. florence
Mr. Florence is an older gentleman in his early sixties. He's wearing grey slacks and a white shirt with skinny light green stripes.

That's not a verb I recognise.

* * *

I beg your pardon?

* * *

>x mr. florence
Mr. Florence is an older gentleman in his early sixties. He's wearing grey slacks and a white shirt with skinny light green stripes.

That's not a verb I recognise.

>x florence
Mr. Florence is an older gentleman in his early sixties. He's wearing grey slacks and a white shirt with skinny light green stripes.

* * *

I beg your pardon?

>t mr. florence
That's not a verb I recognise.

* * *

>x mr. florence
Mr. Florence is an older gentleman in his early sixties. He's wearing grey slacks and a white shirt with skinny light green stripes.

That's not a verb I recognise.

>x grey slacks
You see nothing special about grey slacks.

* * *

>gonear flower vendor
Flower Vendor
Mr. Florence has run the vending cart for as long as you've lived here.

>flatter mr. florence
Mr. Florence becomes visually uncomfortable.

That's not a verb I recognise.

>take mr. florence
That's not a verb I recognise.

>gonear campfire
Campfire
It's night, but the fire just burned out and you both are getting cold. Your tent is in a grassy clearing. To the north are the woods, to the east a stream, and the west a rocky cliff. A mysterious cabin is to your south. In your tent there's a cooler, a backpack, and two sleeping bags.

* * *

>gonear flower vendor
Flower Vendor
Mr. Florence has run the vending cart for as long as you've lived here.

>talk to mr. florence
 Hey, Mr. Florence.

 "How are you?"

That's not a verb I recognise.

I beg your pardon?

* * *

>GONEAR marketplace
Marketplace
You are in the center of the Marketplace. Look around to see where you want to go.

>l
Marketplace
You are in the center of the Marketplace. Look around to see where you want to go.

>l n
You see a cozy Italian Bistro; it's where everyone goes to talk.

>n
Italian Bistro
The Bistro is the coffee and social hub of the town. Everyone gathers here for a bite to eat, something to drink, or to just talk to the other townspeople. There are menus hanging over the counter, scattered round tables, and a sofa.

>x menus
There are two menus hanging over the counter: a food menu and a beverage menu.

>x food menu
Hummus Bagel(4 CP)
Breakfast Pizza(9 CP)
Belgian Waffle(6 CP)
Curry Chicken Salad(7 CP)
Turkey Cranberry Sandwich(7 CP).

>x beverage menu
Our Famous Joe(1 CP)
Cold Brewed Coffee(2 CP)
Espresso Machiato(2 CP)
Americano(2 CP)
Italian Cream Soda(3 CP).

* * *

>gonear dirt path2
Dirt Path
The dirt path continues on. To the north is Stone Valley Pass.

>n
Stone Valley Pass
You approach Stone Valley Pass. There's a warning painted crudely on a wooden sign.

>x warning
Beware, all ye who enter
for the tales tell of tremendous beasts
who crank and crunch and chomp little men like ye
green like untrustfully slithering serpents
ghastly and gruesome and grave.
Beware, all ye who test his guard
for the end is ye boneyard.

>n
You carefully step past the sign into the impending darkness. Your footsteps fall on things that crunch beneath your feet. Soon, you are surrounded by darkness. You can't see anything. You're too scared to move forward without something to illuminate your way. You retrace your steps.

Stone Valley Pass
You approach Stone Valley Pass. There's a warning painted crudely on a wooden sign.

>purloin wand
[Purloined.]

>x wand
A wand made of long, polished, dark wood. You don't know much about it other than that.

>purloin spellbook
Which do you mean, Spellbooks or Advanced Spellbook?

>purloin spellbook
Which do you mean, Spellbooks or Advanced Spellbook?

>gonear wand shop
I only understood you as far as wanting to gonear Wand.

>gonear wand-shop
Wand Shop
The best kept store in town. The inside looks like a library, except instead of books stacked to the ceiling there are long slender boxes. Along the door are buckets of spellbooks.

You can see Wizard here.

>take spellbook
You reach forward and take a book. The wizard is still nowhere to be seen.

>i
You are carrying:
  Spellbook
  Wand

>gonear stone valley pass
There seems to be no such object anywhere in the model world.

>gonear stone valley pass1
Stone Valley Pass
You approach Stone Valley Pass. There's a warning painted crudely on a wooden sign.

>x spellbook
Light: "Levis wand"
Extinguish Light: "Haud Levis Wand"
Attack: "Invado"
Put to Sleep: "Somnus"
Unlock: "resero"

>levis wand
You flick the wand, and the tip glows bright with light.

>n
You carefuly step past the sign into the stone valley pass. You hold your wand up high, trying to illuminate as much of the dark ground as you can. Shadows dart in and out, but the only creatures you see are small bugs and frightful rats.

>x bugs
You can't see any such thing.

>n
Stone Valley Pass
You continue along the path. Up ahead looms the silhouette of a giant beast. The stench of rotting flesh and bad hygene assaults your nose..

You can see Ogre here.

>talk to ogre
(Ogre)

>n
Natural light creeps into the valley as you step back out onto the dirt path.

You try to sneak around the giant ogre, but he bellows at you and blocks your path.

>x spellbook
Light: "Levis wand"
Extinguish Light: "Haud Levis Wand"
Attack: "Invado"
Put to Sleep: "Somnus"
Unlock: "resero"

>somnus
What do you want to somnus?

>somnus ogre
(Ogre)
You flick the wand and confidently cast the spell at the ogre, who falls heavily to the ground with echoing snores.

>take tunic
You have to slay the beast first!

>n
Natural light creeps into the valley as you step back out onto the dirt path.

You quietly sneak past the sleeping ogre.

Stone Valley Pass

>n
Dirt Path
The end of the dirt path forks northeast and northwest.

>l
Dirt Path
The end of the dirt path forks northeast and northwest.

>nw
You turn left onto the path and continue until you come upon a giant Sphinx. She blocks your path. Her tail twitches.

Northwest Path
A continuation of the trail. The path continues northwest while it returns southeast.

You can see Sphinx here.

>nw
"You may not pass." Booms the Sphinx.

>talk to sphinx
"Um, hello?" The sphinx looks at you emotionlessly.
"I have riddles of three," she says. "Answer them all, and ye shall be free." 
"Well, okay-"
"But, fail simply one, and ye shall be none." Attempt her riddles?

>yes
(answer questions: "answer …s:")

"Give me food, and I live. Give me drink, and I die. What am I?"

>answer is water
(to Sphinx)
There is no reply.

>answer is fire
(to Sphinx)
There is no reply.

>answer is flame
(to Sphinx)
There is no reply.

>flame
That's not a verb I recognise.

>answer is
(to Sphinx)
There is no reply.

>answer is a flame
(to Sphinx)
There is no reply.

>talk to sphinx
"Um, hello?" The sphinx looks at you emotionlessly.
"I have riddles of three," she says. "Answer them all, and ye shall be free." 
"Well, okay-"
"But, fail simply one, and ye shall be none." Attempt her riddles?

Please answer yes or no.

>y
(answer questions: "answer …s:")

"Give me food, and I live. Give me drink, and I die. What am I?"

>answer fire
(to Sphinx)
The sphinx looks at you. "Yes." She says simply.

>n
You can't go that way.

>nw
"You may not pass." Booms the Sphinx. "Two more riddles."

I beg your pardon?

>go northwest
"You may not pass." Booms the Sphinx. "Two more riddles."

I beg your pardon?

>talk tp sphinx
I didn't understand that sentence.

>talk to sphinx
"What force and strength cannot get through,
I with a simple action can do.
Many a man would stand,
barred from their abode,
were I not held in their hand."

>answer key
(to Sphinx)
The sphinx remains motionless. "Yes."

>nw
"You may not pass." Booms the Sphinx. "One more riddle."

>talk to sphinx
"I always tell the truth. I show off everything that I see. I come in many shapes and sizes, but I am always flat. I hang and lean off of walls."

>answer mirror
(to Sphinx)
"Yes." She says. She stands up, ruffles her wings, and walks to the side of the path, allowing you to pass through.

>x sphinx
She towers above you with the body of a huge lion and the head of a beautiful woman. Impressive wings are folded at her side.

>nw
Northwest Path
You continue along the path. The sphinx is to the southeast. The trail continues north.

>go northwest
You can't go that way.

I beg your pardon?

>go northwest
You can't go that way.

* * *

I beg your pardon?

>n
As you climb higher up the path the trees around you start to thicken. To the north you see the mouth of a large cave.

Cave
The cave mouth is rather large. It continues north, while the path is south.

>n
You continue into the darkness of the cave, and come upon a giant, floor-to-ceiling steel gate.

>open gate
You rattle the cold bars, but the gate is locked.

>open gate
You rattle the cold bars, but the gate is locked.

>open gate with gate key
I only understood you as far as wanting to open Steel Gate with Steel Gate.

>w
(first opening Steel Gate)
You rattle the cold bars, but the gate is locked.

>s
Cave
The cave mouth is rather large. It continues north, while the path is south.

>s
Northwest Path
You continue along the path. The sphinx is to the southeast. The trail continues north.

>se
Northwest Path
A continuation of the trail. The path continues northwest while it returns southeast.

You can see Sphinx here.

>se
Dirt Path
The end of the dirt path forks northeast and northwest.

>ne
You turn right onto the path and continue until you come upon a lake. The path seems to end here.

Lake
A beautiful lake ends the path.

>n
You tread into the water, but you know you can't hold your breath for long so you return to the shore. Something off to the side catches your eye. Is that a person?

>l
Lake
A beautiful lake ends the path.

You can see Witch here.

>x witch
A younger woman in another of those long black cloaks.

>talk to witch
You approach the witch. "Excuse me, ma'am, but do you know where the path continues?" The woman looks you up and down. She's a younger woman, probably in her thirties.
"Who's asking?" She says suspiciously.
"My name is Wade. I'm not really from around here." She keeps looking at you. "Umm, the blacksmith sent me."
"Ah, yes, the simpleton," she says. "The path continues underwater, at the bottom of the lake."
"How am I supposed to get down there?"
"A simple potion should do it," she says slowly.
"Do you have the recipe?" She pulls a wand out from the folds in her clothes and uses it to conjur up a piece of paper and a pen. When she's finished, she passes you the folded piece of paper. 
"There's a stand over there for your cauldron."

>i
You are carrying:
  Ingredients List
  Spellbook
  Wand

>x ingredients list
-copper cauldron
-cat hair
-caterpillar
- crocodile heart
-dragon claw
-cat eye
-frog brain
- crystal phials

>purloing copper cauldron
That's not a verb I recognise.

>purloing cat hair
That's not a verb I recognise.

>purloin copper cauldron
[Purloined.]

>purloin cat hair
[Purloined.]

>purloin caterpillar
[Purloined.]

>purloin crocodile heart
[Purloined.]

>purloin dragon claw
[Purloined.]

>purloin cat eye
[Purloined.]

>purloin frog brain
[Purloined.]

>purloin crystal phials
[Purloined.]

>x cauldron stand
A stand to fire a cauldron.

>put cauldron on stand
Glad to be rid of the weight, you put the cauldron onto the stand. Instantly a flame lights under the cauldron.

>x cauldron stand
A stand to fire a cauldron.

On Cauldron Stand is Copper Cauldron (empty).

>i
You are carrying:
  Crystal Phials
  frog brain
  cat eye
  dragon claw
  crocodile heart
  caterpillar
  cat hair
  Ingredients List
  Spellbook
  Wand

>put frog brain in cauldron
You put frog brain into Copper Cauldron.

>put cat eye in cauldron
You put cat eye into Copper Cauldron.

>put dragon claw in cauldron
You put dragon claw into Copper Cauldron.

>put crocodile heart in cauldron
You put crocodile heart into Copper Cauldron.

>put caterpillar in cauldron
You put caterpillar into Copper Cauldron.

>put cat hair in cauldron
You put cat hair into Copper Cauldron.

You mix together the last of the ingredients. The potion is thick and deep purple.

>i
You are carrying:
  Crystal Phials
  Ingredients List
  Spellbook
  Wand

>take potion
(first putting Potion into Crystal Phial)

You cork the phial, and turn the breathing potion around in your hands, watching the thick purple liquid roll around under the crystal.

>put potion in phials
You can't see any such thing.

>drink potion
There's nothing suitable to drink here.

>put potion into crystal phials
You can't see any such thing.

>i
You are carrying:
  Breathing Potion
  Ingredients List
  Spellbook
  Wand

>put potion in crystal phials
You can't see any such thing.

>n
You tread into the water, but you know you can't hold your breath for long so you return to the shore.  Perhaps that potion will work.

>l
Lake
A beautiful lake ends the path.

On Cauldron Stand is Copper Cauldron (in which are cat hair, caterpillar, crocodile heart, cat eye and frog brain).

You can also see Witch here.

>talk to witch
"Isn't your potion done yet?" The witch moves away from you.

>drink potion
There's nothing suitable to drink here.

>i
You are carrying:
  Breathing Potion
  Ingredients List
  Spellbook
  Wand

>drink breathing potion
"Here goes nothing," you say, and tip the potion into your mouth. It tastes like a mix of raw octopus and chalk.

>n
lake water
You walk to the edge of the lake and swim out into the center. If the witch was right, then the path should continue straight down…

>i
You are carrying:
  Ingredients List
  Spellbook
  Wand

>n
You can't go that way.

>s
Lake
A beautiful lake ends the path.

On Cauldron Stand is Copper Cauldron (in which are cat hair, caterpillar, crocodile heart, cat eye and frog brain).

You can also see Witch here.

>n
lake water
You walk to the edge of the lake and swim out into the center. If the witch was right, then the path should continue straight down…

>d
You swim down into a tunnel, following it until it spits you out into an underwater world.

Tunnel
The tunnel continues north. To go back to the lake, just swim up.

>n
You enter a city and are speachless. Mermaids are swimming around carelessly and small homes are settled on the floor of the lake, completely sumberged in a giant underwater cave. Glowing orbs line the streets, fill the homes, and adorn the cave walls, bringing a bright but artificial light to the city. A beautiful sandstone castle lays due north.

Mer City
Mer City is beautiful. Mermen and merwomen swim around town as normal as if they were people on land. Each home has a small garden of kelp. The castle gate is north, and the castle lays just behind it.

>n
Mer Castle Gate
The gate to Mer Castle is merely for show, as any creature could swim over the walls. Two guards draped in armor and holding spears are blocking the gate.

You can see Guard here.

>n
The guards block your path. Perhaps you should try talking to them.

>i
You are carrying:
  Ingredients List
  Spellbook
  Wand

>x spellbook
Light: "Levis wand"
Extinguish Light: "Haud Levis Wand"
Attack: "Invado"
Put to Sleep: "Somnus"
Unlock: "resero"

>somnus guard
Why would you put that to sleep?

* * *

>gonear wand shop
I only understood you as far as wanting to gonear Wand.

* * *

>gonear wand-shop
Wand Shop
The best kept store in town. The inside looks like a library, except instead of books stacked to the ceiling there are long slender boxes. Along the door are buckets of spellbooks.

You can see Wizard here.

>talk to wizard
"Hello?" You call out into the stop. You hear a scuffing, then silence. You look around. "Hello?"
"Hello there." You jump, startled. The wizard stands behind you, barely five feet tall. "Now what may I do for you today?" His voice twists around you and makes you uncomfortable. "A wand, me'boy? A wand is what you surely need." You just nod and go long with it. The wizard starts muttering to himself, making circles around you. "Yes, yes, a tall young boy…brown hair, too, yes…perhaps mahagony?…no, no, thating ci's not it." The man skuttles off leaving you alone for several minutes.

Bearing a long slender box, the man hurries back to you. He runs awkwardly; as if his legs are half as long as they should be. "Here, here, me'boy. Try this one. It's perfect, it is." He opens the box, extending it to you. Reaching in, you pick up the long slender piece of wood. It's nicely polished if nothing else. The wizard watches, expectant.
"Well? What do you have to give me for it?" You reach into your pockets and pull out the unicorn hair that ripped out in your hands from the ride. His eyes widen. "Perfect, perfect. This is perfect." He snatches the hair from you and skuttles back into the depths of his shop.

>x spellbooks
Books full of spells.

>take
(Wizard)
I don't suppose Wizard would care for that.

>take spellbooks
You reach forward and take a book. The wizard is still nowhere to be seen.

>talk to wizard
"Hello?" You call out into the stop. You hear a scuffing, then silence. You look around. "Hello?"
"Hello there." You jump, startled. The wizard stands behind you, barely five feet tall. "Now what may I do for you today?" His voice twists around you and makes you uncomfortable. "A wand, me'boy? A wand is what you surely need." You just nod and go long with it. The wizard starts muttering to himself, making circles around you. "Yes, yes, a tall young boy…brown hair, too, yes…perhaps mahagony?…no, no, thating ci's not it." The man skuttles off leaving you alone for several minutes.

Bearing a long slender box, the man hurries back to you. He runs awkwardly; as if his legs are half as long as they should be. "Here, here, me'boy. Try this one. It's perfect, it is." He opens the box, extending it to you. Reaching in, you pick up the long slender piece of wood. It's nicely polished if nothing else. The wizard watches, expectant.
"Well? What do you have to give me for it?" You reach into your pockets and pull out the unicorn hair that ripped out in your hands from the ride. His eyes widen. "Perfect, perfect. This is perfect." He snatches the hair from you and skuttles back into the depths of his shop.

>l
Wand Shop
The best kept store in town. The inside looks like a library, except instead of books stacked to the ceiling there are long slender boxes. Along the door are buckets of spellbooks.

You can see Wizard here.

>talk to wizard
"Hello?" You call out into the stop. You hear a scuffing, then silence. You look around. "Hello?"
"Hello there." You jump, startled. The wizard stands behind you, barely five feet tall. "Now what may I do for you today?" His voice twists around you and makes you uncomfortable. "A wand, me'boy? A wand is what you surely need." You just nod and go long with it. The wizard starts muttering to himself, making circles around you. "Yes, yes, a tall young boy…brown hair, too, yes…perhaps mahagony?…no, no, thating ci's not it." The man skuttles off leaving you alone for several minutes.

Bearing a long slender box, the man hurries back to you. He runs awkwardly; as if his legs are half as long as they should be. "Here, here, me'boy. Try this one. It's perfect, it is." He opens the box, extending it to you. Reaching in, you pick up the long slender piece of wood. It's nicely polished if nothing else. The wizard watches, expectant.
"Well? What do you have to give me for it?" You reach into your pockets and pull out the unicorn hair that ripped out in your hands from the ride. His eyes widen. "Perfect, perfect. This is perfect." He snatches the hair from you and skuttles back into the depths of his shop.

>i
You are carrying:
  Wand
  Spellbook

>x wand
A wand made of long, polished, dark wood. You don't know much about it other than that.

>i
You are carrying:
  Wand
  Spellbook

>restart
Are you sure you want to restart?

>y
You've planned a wonderful camping trip with your girlfriend. She's depending on you to make the experience memorable, but everything keeps going wrong for you.

An Experience
The Beginning by Kapri Lisehora
Release 1 / Serial number 130302 / Inform 7 build 6G60 (I6/v6.32 lib 6/12N) SD

Campfire
It's night, but the fire just burned out and you both are getting cold. Your tent is in a grassy clearing. To the north are the woods, to the east a stream, and the west a rocky cliff. A mysterious cabin is to your south. In your tent there's a cooler, a backpack, and two sleeping bags.

You can see a cooler (closed), a backpack (closed) and sleeping bags here.

>gonear wand-shop
Wand Shop
The best kept store in town. The inside looks like a library, except instead of books stacked to the ceiling there are long slender boxes. Along the door are buckets of spellbooks.

You can see Wizard here.

>i
You are carrying nothing.

>take spellbooks
You should probably talk to the wizard shopkeeper before you take that.

>i
You are carrying nothing.

>take spellbook
You should probably talk to the wizard shopkeeper before you take that.

>i
You are carrying nothing.

>talk to wizard
"Hello?" You call out into the stop. You hear a scuffing, then silence. You look around. "Hello?"
"Hello there." You jump, startled. The wizard stands behind you, barely five feet tall. "Now what may I do for you today?" His voice twists around you and makes you uncomfortable. "A wand, me'boy? A wand is what you surely need." You just nod and go long with it. The wizard starts muttering to himself, making circles around you. "Yes, yes, a tall young boy…brown hair, too, yes…perhaps mahagony?…no, no, thating ci's not it." The man skuttles off leaving you alone for several minutes.

Bearing a long slender box, the man hurries back to you. He runs awkwardly; as if his legs are half as long as they should be. "Here, here, me'boy. Try this one. It's perfect, it is." He opens the box, extending it to you. Reaching in, you pick up the long slender piece of wood. It's nicely polished if nothing else. The wizard watches, expectant.
"Well? What do you have to give me for it?" You reach into your pockets and pull out the unicorn hair that ripped out in your hands from the ride. His eyes widen. "Perfect, perfect. This is perfect." He snatches the hair from you and skuttles back into the depths of his shop.

>i
You are carrying:
  Wand

>take spellbook
You reach forward and take a book. The wizard is still nowhere to be seen.

>w
Town Center
The town center is a worn and dusty clearing to which the surrounding shops are circled around. The cobblestone path lies to the south. To the west is One Stop Alchemist, northwest is an armory, the blacksmith is north, a wand shop to the east, and a store called "Beasts" to the southeast.

>n
You knock on the closed, apparently windowless, blacksmith shop. The blacksmith opens the door for you. He looks at you gruffyly. "What do you want."
"I'm new in town… I'm not really from around these parts." The gruff man looks you up and down.
"Obviously." He becons you in, and steps aside. You enter one giant room with a door to the north and a door to the east, which seems to lead to his private quarters. "Did a unicorn bring you?" You nod, amazed that you're still finding things suprising today. The man nods in response, and kicks a stool at you. "I got a few words to say to you, boy. Got a minute?"

Please answer yes or no.

>yes
You nod, adjusting your weight on the rocking rickety stool.
"I used to be like you, kid."
"Wade."
"What?. I used to live down south where the normal people live. I used to go to restaurants and buy flowers for all the girls in my life. I used to be a real charmer, you know. But I met a man named Hayden. That must have been fifty years ago. Amara brought me here."
"Well, that all sounds familiar."
"Hayden sent me here for a personal quest of my own, but I was just overtaken by this land, boy. This world is beyond your most glorious imaginations. Sure, it snows ninety perfect of the time, but the air smells of magic and I fell in love. I'm warning you now, boy. This world will steal your heart away. If you truly want to go home, then you must find your way. But if you decide to stay, I could help you along." You look at the man, and think of Elily. You had to return to her. Right? 
"Mr. Blacksmith," you say. "How might I find my way out of here?"
 The man sighs. "There's a dirt path behind my shop that leads north to the mountains. I've heard tale of a magic portal up there. I'm sure that could get you back home."

"Wait, kid. Look, it gets dangerous up there. Go to the armory and pick up some weapons."

>s
Town Center
The town center is a worn and dusty clearing to which the surrounding shops are circled around. The cobblestone path lies to the south. To the west is One Stop Alchemist, northwest is an armory, the blacksmith is north, a wand shop to the east, and a store called "Beasts" to the southeast.

>nw
You step into the armory to see some familiar -or atleast nonmagic- items. A cannon and a pitchfork sit on either side of an extravagent weapons cabinet. The burly man behind the counter wears leather and off white cloth. His eyes follow you untrustfully.

>take weapons
That's fixed in place.

>talk to man
"Ugh, what do you want, kid. I really think you're too tiny for these weapons. How will you be paying for these?"
"The blacksmith sent me," you say, having forgotten completely about money.
"Oh. Fine. Take whatever you want, kid."

>x weapons case
A floor-to-ceiling wooden display case with a glass door. Inside, supported by racks, are many different weapons: Sword, Blunt Weapon, Spear, Axe and Shield.

>take all
There are none at all available!

>take sword
You can't see any such thing.

>open weapons case
You open Weapons Case, revealing Sword, Blunt Weapon, Spear, Axe and Shield.

>take all
Sword: Taken.
Blunt Weapon: Taken.
Spear: Taken.
Axe: Taken.
Shield: Taken.

>i
You are carrying:
  Shield
  Axe
  Spear
  Blunt Weapon
  Sword
  Spellbook
  Wand

>x spellbook
Light: "Levis wand"
Extinguish Light: "Haud Levis Wand"
Attack: "Invado"
Put to Sleep: "Somnus"
Unlock: "resero"

>invado
What do you want to invado?

>somnus
What do you want to somnus?

>somnus burly man
Why would you put that to sleep?

>resero weapons case
You try out the spell on the weapons case. It unlocks.

>lock weapons case
What do you want to lock Weapons Case with?

>se
You can't see any such thing.

>go southeast
Town Center
The town center is a worn and dusty clearing to which the surrounding shops are circled around. The cobblestone path lies to the south. To the west is One Stop Alchemist, northwest is an armory, the blacksmith is north, a wand shop to the east, and a store called "Beasts" to the southeast.

>n
The blacksmith looks up, sees that it is you, and returns to his work.

>l
Blacksmith
A large one-room shop. There's a door to the north and the Town Center to the south.

You can see Blacksmith here.

>n
You start walking up the dirt path. The steady incline starts to steal your breath in the thin mountain air. Up ahead, you see a small cottage.

Dirt Path
A simple path worn down by frequent use.

>n
You rap on the door. An old man, unged in a floor length black cloak answers the door.
"Oh, lovely. You're here. Come, come." the man hobbles back into his home. Follow him?

>yes
"Um, sure," you mutter to yourself and step into the cottage. Humble furnature compliments the interior of the modest living space. In the center of the room, resting on a nest of unprotected blue flames sits a large cast iron cauldron. The blue fire licks the floor and surrounding furnature but doesn't leave a mark. The wizard looks over into the cauldron.

Small Cottage
A small one or two room cottage.

You can see Wizard here.

>l
Small Cottage
A small one or two room cottage.

You can see Wizard here.

>x fire
You can't see any such thing.

>x furnature
You can't see any such thing.

>talk to wizard
"Hey, did you need me for something?"
"Ah, yes, m'boy. Look. I'm an old fellow." You look. He spoke an obvious truth. "I need a few things from the potions store. I will pay you when you return. Can you do that for me?"

>y
"Sure.. I think I can handle that. What do you need?"
"Here's a list. Thanks, son." the wizard hands you a piece of partchment written on in medieval caligraphy.

>i
You are carrying:
  Shopping List
  Shield
  Axe
  Spear
  Blunt Weapon
  Sword
  Spellbook
  Wand

>x shopping list
- bat blood
- fairy wings
- octopu powder
- rose thorns

>purloin ingredients list
[Purloined.]

>x ingredients list
-copper cauldron
-cat hair
-caterpillar
- crocodile heart
-dragon claw
-cat eye
-frog brain
- crystal phials

>drop ingredients list
Dropped.

>i
You are carrying:
  Shopping List
  Shield
  Axe
  Spear
  Blunt Weapon
  Sword
  Spellbook
  Wand

>s
Dirt Path
A simple path worn down by frequent use.

>s
Blacksmith
A large one-room shop. There's a door to the north and the Town Center to the south.

You can see Blacksmith here.

>s
Town Center
The town center is a worn and dusty clearing to which the surrounding shops are circled around. The cobblestone path lies to the south. To the west is One Stop Alchemist, northwest is an armory, the blacksmith is north, a wand shop to the east, and a store called "Beasts" to the southeast.

>w
You step cautiously into what appears to be a potions shop. You see a display table with a few cauldrons on it. Mounted on the wall is an ingredients cabinet stocked with what appears to be potion ingredients. The potions shopkeeper seems to have stepped out.

One Stop Alchemist
One Stop Alchemist is a potions shop. Dirty windows frame the door.

You can see a Counter and Ingredients Cabinet (closed) here.

>open cabinet
It seems to be locked.

>unlock cabinet
What do you want to unlock Ingredients Cabinet with?

>x counter
A simple counter.

>look under counter
You rummage under the counter and find a key.

>i
You are carrying:
  cabinet key
  Shopping List
  Shield
  Axe
  Spear
  Blunt Weapon
  Sword
  Spellbook
  Wand

>unlock cabinet
What do you want to unlock Ingredients Cabinet with?

>unlock cabinet with cabinet key
You unlock Ingredients Cabinet.

>take all
There are none at all available!

>x cabinet
A large hanging wooden cabinet with glass doors to display an arrange of different potion incredients.You can see Glass Phials, Crystal Phials, bat blood, cat hair, caterpillar, crocodile heart, dragon claw, cat eye, fairy wings, frog brain, griffin claw, leech juice, octopus powder, peacock feathers, rose thorn, salamander blood and turtle shell.

>take all
There are none at all available!

>open cabinet
You open Ingredients Cabinet, revealing Glass Phials, Crystal Phials, bat blood, cat hair, caterpillar, crocodile heart, dragon claw, cat eye, fairy wings, frog brain, griffin claw, leech juice, octopus powder, peacock feathers, rose thorn, salamander blood and turtle shell.

>take al
You can't see any such thing.

>take all
Glass Phials: Taken.
Crystal Phials: Taken.
bat blood: Taken.
cat hair: Taken.
caterpillar: Taken.
crocodile heart: Taken.
dragon claw: Taken.
cat eye: Taken.
fairy wings: Taken.
frog brain: Taken.
griffin claw: Taken.
leech juice: Taken.
octopus powder: Taken.
peacock feathers: Taken.
rose thorn: Taken.
salamander blood: Taken.
turtle shell: Taken.

>i
You are carrying:
  turtle shell
  salamander blood
  rose thorn
  peacock feathers
  octopus powder
  leech juice
  griffin claw
  frog brain
  fairy wings
  cat eye
  dragon claw
  crocodile heart
  caterpillar
  cat hair
  bat blood
  Crystal Phials
  Glass Phials
  cabinet key
  Shopping List
  Shield
  Axe
  Spear
  Blunt Weapon
  Sword
  Spellbook
  Wand

>e
Town Center
The town center is a worn and dusty clearing to which the surrounding shops are circled around. The cobblestone path lies to the south. To the west is One Stop Alchemist, northwest is an armory, the blacksmith is north, a wand shop to the east, and a store called "Beasts" to the southeast.

>n
Blacksmith
A large one-room shop. There's a door to the north and the Town Center to the south.

You can see Blacksmith here.

>n
Dirt Path
A simple path worn down by frequent use.

>n
Small Cottage
A small one or two room cottage.

You can see Ingredients List and Wizard here.

>x ingredients list
-copper cauldron
-cat hair
-caterpillar
- crocodile heart
-dragon claw
-cat eye
-frog brain
- crystal phials

>take ingredients list
Taken.

>x wizard
You see nothing special about Wizard.

>talk to wizard
"Hey, mister…" you let yourself into the cottage. The man is slaving away over his cauldron. You can see the sweat drenching his face. A drop falls into the potion which then gives off a tremendous hiss. He curses, then sees you.

"Oh, thank Merlin you're here. Come, come, give me those." He snatches the ingredients from your hands.
Watch the deranged man make his potion?

>y
You watch, memorized, as the wizard dashes in the octopus powder, mixing it in by swirling his hands over the cauldron. He adds a drop of bat blood and the potion begins to boil, emitting a purple steam.
"Careful not to breathe this," he coughs at you. The fairy wings go in next ,and he mixes them in until the potion turns white and comes to a simmer, then throws in a handful of rose thorns. "One extra for good luck, eh?" He winks at you, flicking one last thorn into the cauldron. The potion lights up the room with a bang, blinding you. When your sight returns, you're standing alone on the dirt path.

The dirt path continues on. To the north is Stone Valley Pass.

>s
Small Cottage
The charred remains of a small one or two room cottage.

>s
Dirt Path
A simple path worn down by frequent use.

>n
Small Cottage
The charred remains of a small one or two room cottage.

>enter small cottage
You can't see any such thing.

>n
The dirt path continues on. To the north is Stone Valley Pass.

>n
Stone Valley Pass
You approach Stone Valley Pass. There's a warning painted crudely on a wooden sign.

>x warning
You can't see any such thing.

>x wooden sign
Beware, all ye who enter
for the tales tell of tremendous beasts
who crank and crunch and chomp little men like ye
green like untrustfully slithering serpents
ghastly and gruesome like gorgon.
Beware, all ye who enter
for the end is your boneyard.

* * *

>make out with girlfriend
That's not a verb I recognise.

>kiss
(yourself)
If you think that'll help.

>kiss girlfriend
You lean forward to kiss your girlfriend, but think better of it. She's not in the best mood; you've ruined her weekend.

>do it anyway
That's not a verb I recognise.

>e
It's dark outside. Are you sure?

>yes
A wild beast that you couldn't see in the darkness attacks you.

    *** You have died ***

In that game you scored 0 out of a possible 44, in 3 turns.

Would you like to RESTART, RESTORE a saved game, QUIT or UNDO the last command?

>u
Please give one of the answers above.

Would you like to RESTART, RESTORE a saved game, QUIT or UNDO the last command?

>undo
Campfire
[Previous turn undone.]

>x backpack
A simple bag that's seen better days. Nevertheless, you managed to stuff it with necessities and bring it on the trip.

>open backpack
You open the backpack, revealing a lighter, a candle and a flashlight.

>take items
You can't see any such thing.

>take all
backpack: Taken.
lighter: Taken.
candle: Taken.
flashlight: Taken.

>i
You are carrying:
  a flashlight
  a candle
  a lighter
  a backpack (open but empty)

>close backpack
You close the backpack.

>take backpack
You already have that.

>e
It's dark outside. Are you sure?

* * *

>use flashlight
That's not a verb I recognise.

>turn on flashlight
You switch the flashlight on.

>e
Within a few dozen paces you arrive at the stream.

>x stream
You can't see any such thing.

>x water
Cold and (hopefully) clean.

>open bottle
You can't see any such thing.

>take water
You try desperately to cup the water in your hands, but they just aren't sufficient enough.

>i
You are carrying:
  a flashlight
  a candle
  a lighter
  a backpack (closed)

>w
Campfire
It's night, but the fire just burned out and you both are getting cold. Your tent is in a grassy clearing. To the north are the woods, to the east a stream, and the west a rocky cliff. A mysterious cabin is to your south. In your tent there's a cooler, a backpack, and two sleeping bags.

You can see a cooler (closed) and sleeping bags here.

>open cooler
You open the cooler, revealing Bottles.

>take bottles
Taken.

>e
Within a few dozen paces you arrive at the stream.

>x water
Cold and (hopefully) clean.

>take water
You dip the mouth of each bottle into the stream until they are full of water.

>w
Campfire
It's night, but the fire just burned out and you both are getting cold. Your tent is in a grassy clearing. To the north are the woods, to the east a stream, and the west a rocky cliff. A mysterious cabin is to your south. In your tent there's a cooler, a backpack, and two sleeping bags.

You can see a cooler (empty) and sleeping bags here.

>drink water
The water tastes fine to you, so you give your girlfriend a reassuring smile. She takes a sip.

[Your score has just gone up by one point.]

>n
Woods
You venture outside towards the woods. You can hear the branches creaking and laughing at your misfortune. Somewhere, an owl hoots a solemn tune before being abruptly cut off. You shiver both from the cold and from the darkness. Tangled in the thorny holly trees are the dead branches of their taller brothers.

You can see a holly tree (on which is Branches) here.

>x owl
You can't see the bird, but the echo of its last half-"hoot" rings in your ears.

>x tree
You step closer and trip into the thorns, scratching your arms and snagging your shirt. It's dark, cold, and windy. Is this really the best time and place to leave your girl alone?

On the holly tree is Branches.

[Your score has just gone up by one point.]

>x branches
Branches is currently switched off.

>turn on branches
If you light these here, you're going to have to carry an armful of fire all the way back to the campfire.

>light branches
Please answer yes or no.

* * *

>light branches
If you light these here, you're going to have to carry an armful of fire all the way back to the campfire.

>yes
The fire turns out to be too much to bear, and burns you severely.

    *** You have died ***

In that game you scored 2 out of a possible 44, in 28 turns.

Would you like to RESTART, RESTORE a saved game, QUIT or UNDO the last command?

>undo
Woods
[Previous turn undone.]

>take branches
Taken.

>x owl
You can't see the bird, but the echo of its last half-"hoot" rings in your ears.

>yell
(at yourself)

>yes
That was a rhetorical question.

>w
You can't go that way.

>s
Campfire
It's night, but the fire just burned out and you both are getting cold. Your tent is in a grassy clearing. To the north are the woods, to the east a stream, and the west a rocky cliff. A mysterious cabin is to your south. In your tent there's a cooler, a backpack, and two sleeping bags.

You can see a cooler (empty) and sleeping bags here.

>light branches
You kindle a small fire, and your girlfriend is thankful for the warmth. However, you forgot to pack any food and the extinction of the first fire cost you the last of the daylight hours.

>go to sleep
You can't see any such thing.

>sleep with girlfriend
I only understood you as far as wanting to sleep.

>x
What do you want to examine?

>s
You see nothing unexpected in that direction.

>s
Brandishing your faithful flashlight you cautiously make your way to the spooky old abandoned cabin you passed on your way to the camping location. Wind rushes through the top of the nearby woods and over your head, only to plummet down the rocky cliff. The cabin looms before you. There's an outhouse to the east.

>e
Outhouse
You arrive at an old wooden outhouse. You notice an overturned wheelbarrow behind it. With a heavy push the door gives way to a small room full of stale air and forgotten spiderwebs. Up on a shelf is a toolbox. At your feet lies a trapdoor and the toilet function is nestled in the corner to your right.

You can see a trapdoor here.

>x wheelbarrow
Holding your flashlight with two hands, like a sword, you make your way to an old overturned wooden wheelbarrow.

Small plants had made their homes between the cracks in the wood and cast eerie shadows across the ground. Here you find a hammer.

>take hammer
Taken.

>w
cabin
It appears to be a small cabin with an outhouse to the east. The windows are boarded up and the oak door looks solid.

You can see an oak door and a Master lock here.

>e
Outhouse
You arrive at an old wooden outhouse. You notice an overturned wheelbarrow behind it. With a heavy push the door gives way to a small room full of stale air and forgotten spiderwebs. Up on a shelf is a toolbox. At your feet lies a trapdoor and the toilet function is nestled in the corner to your right.

You can see a trapdoor here.

>x toolbox
A standard old toolbox covered in dark stains that you can't make out in your flashlight's feeble beam.

[Your score has just gone up by one point.]

>open toolbox
That's not something you can open.

>break toolbox
Violence isn't the answer to this one.

>yes it is
I only understood you as far as wanting to yes.

>close door
You can't see any such thing.

>open trapdoor
Are you sure? Remember, you are in an outhouse.

>yes
Against your better judgement you lift the knarly trapdoor and make your way down the rickety ladder into a pit of darkness. The air is damp and reeks of mildew. Your flashlight cuts out and your foot lands on something crunchy.

hole
You drop down into a dark hole. The blackness is extreme, and you have no idea how large the room is. It looks like one giant shadow.

You can see a trapdoor here.

>light candle
The feeble flame of the candle only makes the room more haunted as the shadows jump over the dirt walls and hide behind larger black masses. The silence echoes in your ears; bounching off the walls and forcing an almost unbreathable stench of rotten earth and death into your nose.

[Your score has just gone up by one point.]

>x walls
You can't see any such thing.

>x wall
You reach out, feeling up and down the crumbling walls of the hole. In some places the dirt is sticky and wet. Your hands come into contact with a box. It's made of metal and cold to the touch.

[Your score has just gone up by five points.]

>open box
The door to the safe takes a few tugs before it begrudgingly opens. You can't see what's inside, but you're sure there must be something.

>use hammer
That's not a verb I recognise.

>turn on flashlight
You switch the flashlight on.

>x box
You can't see it, but it appears to be a cast iron safe.

In Box is Rose.

>take rose
[Your score has just gone up by two points.]

>take all
There are none at all available!

>i
You are carrying:
  Rose
  a hammer
  Branches
  a flashlight
  a candle
  a lighter
  a backpack (closed)

>w
You can't go that way.

>e
You can't go that way.

>a
That's not a verb I recognise.

>u
You clamber desperately back up the rotting rope ladder. Your flashlight flickers back to life.

>x toilet
A crude replication of the luxury you use at home.

[Your score has just gone up by one point.]

>use toilet
That's not a verb I recognise.

>w
You venture into the blackness with the feeble glow of the candle dancing dangerously, but the flame is blown out within a few steps.

>uw
That's not a verb I recognise.

>w
cabin
It appears to be a small cabin with an outhouse to the east. The windows are boarded up and the oak door looks solid.

You can see an oak door and a Master lock here.

>w
You can't go that way.

>n
Campfire
It's night, but the fire just burned out and you both are getting cold. Your tent is in a grassy clearing. To the north are the woods, to the east a stream, and the west a rocky cliff. A mysterious cabin is to your south. In your tent there's a cooler, a backpack, and two sleeping bags.

You can see a cooler (empty) and sleeping bags here.

>give rose
(to yourself)
You juggle Rose for a while, but don't achieve much.

>give rose to girlfriend
You bow slightly with your hand outstretched, offering the rose to your girlfriend. She smiles and accepts it.

>s
cabin
It appears to be a small cabin with an outhouse to the east. The windows are boarded up and the oak door looks solid.

You can see an oak door and a Master lock here.

>break lock
Violence isn't the answer to this one.

>x lock
 A simple lock with a key broken off inside. It looks like you'll have to look around for something to break it.

>use hammer
That's not a verb I recognise.

>break lock
Violence isn't the answer to this one.

>break lock with hammer
The head of the hammer thuds into the lock with a dull *clink* and breaks it.

>x lock
A broken lock. It's worth no more than the metal it's made of.

>enter cabin
You can't see any such thing.

>enter
You must supply a noun.

>enter door
The door creaks heavily, sucking in wind and shadows. The room you enter consists of a fireplace, a sofa, and a kitchenette.

cabin interior
The room consists of a solitary sofa infront of a fireplace, and a kitchenette.

You can see an oak door and a kitchenette here.

>take kitchenette
That's fixed in place.

>x sofa
A disgrace to the "70"s, but nevertheless a sofa from that time. The ugly floral pattern is fadded and the cloth on the arm wrests is worn through.

[Your score has just gone up by one point.]

>look under sofa
Just a family of dead dust mites.

[Your score has just gone up by two points.]

>take dust mites
As lovely a gift you think dust would be, I promise you're wrong.

>and?
That's not a verb I recognise.

>take sofa
That's hardly portable.

>take sofa
That's hardly portable.

>x kitchenette
Here you find several dollar-store white plates and a couple cans of soup whose expiration dates haven't yet been reached.

>take food
You can't see any such thing.

>take cans
You can't see any such thing.

>x cans
You can't see any such thing.

>x plates
Ten milky-white, cheap plates. The skeletons of dead bugs are solidified to their surfaces.

[Your score has just gone up by one point.]

>take bugs
You can't see any such thing.

>take plates
That's hardly portable.

>take soup
Taken.

>i
You are carrying:
  Soup
  a hammer
  Branches
  a flashlight
  a candle
  a lighter
  a backpack (closed)

>l
cabin interior
The room consists of a solitary sofa infront of a fireplace, and a kitchenette.

You can see an oak door and a kitchenette here.

>x fireplace
The last user had apparently forgotten to clean the fireplace. A thick pile of ashes lay under a thick layer of dust.

>x ashes
A fluffy pile of soot.

>take ashes
You try desperately to scoop the ashes up, but they fall through your fingers. Don't feel too bad about it, though. I don't really think your girlfriend would think that's a nice present anyway.

>x door
The door is made of old, thick oak planks and has an iron cage over the peephole. A bullet is lodged to the right of the bars.  Pieces of a broken lock dangle uselessly.

>x bullet
You can't see any such thing.

>n
cabin
It appears to be a small cabin with an outhouse to the east. The windows are boarded up and the oak door looks solid.

You can see an oak door and a Master lock here.

>x door
The door is made of old, thick oak planks and has an iron cage over the peephole. A bullet is lodged to the right of the bars.  Pieces of a broken lock dangle uselessly.

>s
cabin interior
The room consists of a solitary sofa infront of a fireplace, and a kitchenette.

You can see an oak door and a kitchenette here.

>n
cabin
It appears to be a small cabin with an outhouse to the east. The windows are boarded up and the oak door looks solid.

You can see an oak door and a Master lock here.

>n
Campfire
It's night, but the fire just burned out and you both are getting cold. Your tent is in a grassy clearing. To the north are the woods, to the east a stream, and the west a rocky cliff. A mysterious cabin is to your south. In your tent there's a cooler, a backpack, and two sleeping bags.

You can see a cooler (empty) and sleeping bags here.

>eat food
You can't see any such thing.

>eat soup
The soup singes your tongue, but you're grateful. You fear if it was cooler you'd be able to taste the cabin in it. (I hope you have something to wash this down!)

You survived the camping trip! However, your girlfriend isn't very happy with you. You promised her a wonderful weekend, but there was literally nothing wonderful about it. You fed her sketchy soup that you stole from a cabin that you broke into, for heaven's sake!
But that was last weekend. It's Saturday morning, and you're in the Marketplace. You want to make it up to your girl, but you're not quite sure how. I guess the first thing would be to stop calling her "girl" or "girlfriend". She has a name. It's Elily. Now, look around. Maybe you'll see something to inspire you. (remember, NW, SW, NE and SE are directions)
Marketplace
You are in the center of the Marketplace. Look around to see where you want to go.

[Your score has just gone up by one point.]

>look n
You see a cozy Italian Bistro; it's where everyone goes to talk.

>look ne
You spy the park; you and Elily used to have picnics there.

>look e
You see an older man selling flowers.

>look se
You see Ms. Baker's Garden.

>look s
A small Appliance Store.

>look sw
You see the town Bank.

>look w
You look to the west and see the school.

>look nw
A simple General Store.

>go n
Italian Bistro
The Bistro is the coffee and social hub of the town. Everyone gathers here for a bite to eat, something to drink, or to just talk to the other townspeople. There are menus hanging over the counter, scattered round tables, and a brown sofa.

You can see Mr. Mason and Hayden here.

>steal food
That's not a verb I recognise.

>x menu
Which do you mean, Food Menu or Beverage Menu?

>food
Hummus Bagel(4 CP)
Breakfast Pizza(9 CP)
Belgian Waffle(6 CP)
Curry Chicken Salad(7 CP)
Turkey Cranberry Sandwich(8 CP).

>i
You are carrying nothing.

>x beverage menu
Our Famous Joe(1 CP)
Cold Brewed Coffee(2 CP)
Espresso Machiato(2.5 CP)
Americano(1.5 CP)
Italian Cream Soda(3 CP).

>talk to Mr. Mason
Mr. Mason is a busy man. You shouldn't bother him unless it's important.

That's not a verb I recognise.

>talk to hayden
"Hello, Hayden." You sit down on the sofa next to him. He continues to look into his coffee mug.

"Wade," he acknowledges.

"How do you know my-" Hayden looks up at you. "Never mind." Hayden holds your gaze for another second, then drops it to his mug and takes a sip.

"Anyone can buy a girl flowers, Wade." He says. You become uncomfortable. "I think you should do something a little more special for her, Wade. She's worth more than flowers." You shift in your seat.

"Well, I have other ideas, too-"

"Ah."

"Do you have a better idea, sir?" Hayden chuckles.

"I'm no "sir". But yes. I do. A beautiful girl like Elily? Flowers are silly. Would you like to know of my idea?"

>yes
"Ahh, yes. Have you ever been to the forest, Wade? It's just northeast of the park."

"I've biked the trails a time or two, yes."

"There is a wonderful creature, in those trees, Wade. She sparkles and glistens and flies like the wind," his voice trails. "You must find her, Wade. And you must tame her. And she will take you to wonderous places."

"What, what do you mean?" Hayden has completely lost you. "A flying creature that I can tame and ride? What are you talking about." Hayden smiles.

"I'm rather hungry, Wade. Why don't you buy me a Curry Chicken Salad, and we can talk about it."
You continue to look at Hayden, but he ignores you and your abscence of Curry Chicken Salad.

>buy curry chicken salad
Why don't you try to take that instead.

>take curry chicken salad
You can't steal this! It costs a Seven Coin Piece. Try later when you have the money.

>take money
You can't see any such thing.

>s
Marketplace
You are in the center of the Marketplace. Look around to see where you want to go.

>l
Marketplace
You are in the center of the Marketplace. Look around to see where you want to go.

>ne
Park
A lovely little park. It has a few tall trees and a picnic bench. It looks like someone abandoned their picnic here.

>x trees
Which do you mean, Tall Trees or Black Cherry Trees?

>tall trees
There are a couple black cherry trees and a willow tree.

>x black cherry trees
There are only three of them. Their leaves are smooth and shiny.

>take leaves
That's hardly portable.

>x willow tree
The willow tree is definately the oldest thing in the park. It's long leaves and branches brush the ground, and its trunk is scarred.

>take branches
You can't see any such thing.

>ne
You don't feel like going for a hike right now, so you return to the park.

Park
A lovely little park. It has a few tall trees and a picnic bench. It looks like someone abandoned their picnic here.

>sw
Marketplace
You are in the center of the Marketplace. Look around to see where you want to go.

>se
Garden
Ms. Baker is an elderly old woman who takes are of her garden as if it were a newborn baby. She's a frail lady, and often needs help with errands.

You can see Ms. Baker here.

>talk to ms baker
"Hey, Ms. Baker. How are you?" You say laoudly as you approach the older woman. She looks up and beams at you.

"Wade! It's so nice to see you again!" She brushes her hands off on her apron and gives you a hug. "I'm doing just fine, sweety."

"Well, I'm very glad to hear that, Ms. Baker. Is there anything I can help you with?"

"Hmm," she says as she puts her left hand on her hip. "Actually, there is. Do you think that you could take this crate of vegetables to Mr. Mason in the Italian Bistro? Make sure to bring back the check he gives you, and I'll have something special for you." She leads you to a wooden crate. With a grunt, you pick it up.

"Thanks again, dear."

"No problem, Ms. Baker. I'll be right back."

>nw
Marketplace
You are in the center of the Marketplace. Look around to see where you want to go.

>n
Italian Bistro
The Bistro is the coffee and social hub of the town. Everyone gathers here for a bite to eat, something to drink, or to just talk to the other townspeople. There are menus hanging over the counter, scattered round tables, and a brown sofa.

You can see Mr. Mason and Hayden here.

>i
You are carrying:
  Wooden Crate

>mr mason
That's not a verb I recognise.

>give crate to mr mason
"Hey, Mr. Mason?" You say, approaching the manager.

"Yes? Ah," he says, seeing the crate. "Thank you," he says as he takes the crate from you. "Here, be sure to give this to Ms. Baker." He hands you a check and takes the crate to he back of the store.

>s
Marketplace
You are in the center of the Marketplace. Look around to see where you want to go.

>ne
Park
A lovely little park. It has a few tall trees and a picnic bench. It looks like someone abandoned their picnic here.

>we
That's not a verb I recognise.

>sw
Marketplace
You are in the center of the Marketplace. Look around to see where you want to go.

>sw
You climb the stone steps and enter the bank, looking around. The teller looks up at you.

>ne
Marketplace
You are in the center of the Marketplace. Look around to see where you want to go.

>e
Flower Vendor
Mr. Florence has run the vending cart for as long as you've lived here.

Mr. Florence is refilling the water for some of the flowers.

You can also see Wildflowers, Azaleas, Pink Lilies, White Lilies, Daffodils, Irises, Jasmine Blossoms, Marigolds and Daisies here.

>w
Marketplace
You are in the center of the Marketplace. Look around to see where you want to go.

>w
School
The school is small, but you have good memories from it. You can see your computer science teacher, Mr. DK, leaning against the wall, playing on his iPad. He's known to be a fan of Steve Jobs.

You can see Mr. DK here.

>e
Marketplace
You are in the center of the Marketplace. Look around to see where you want to go.

>se
Garden
Ms. Baker is an elderly old woman who takes are of her garden as if it were a newborn baby. She's a frail lady, and often needs help with errands.

You can see Ms. Baker here.

>give check to ms baker
Ms. Baker doesn't seem interested.

>give payment check to ms baker
Ms. Baker doesn't seem interested.

>i
You are carrying:
  Payment Check

>give payment check to ms. baker
Ms. Baker doesn't seem interested.

That's not a verb I recognise.

>talk to ms baker
"Here, Ms. Baker." You hand over the check.

"Oh, thank you dear! And here's a little something for you." Ms. Baker hands you a nine coin piece.

>nw
Marketplace
You are in the center of the Marketplace. Look around to see where you want to go.

>e
Flower Vendor
Mr. Florence has run the vending cart for as long as you've lived here.

Mr. Florence is refilling the water for some of the flowers.

You can also see Wildflowers, Azaleas, Pink Lilies, White Lilies, Daffodils, Irises, Jasmine Blossoms, Marigolds and Daisies here.

* * *

>w
School
The school is small, but you have good memories from it. You can see your computer science teacher, Mr. DK, leaning against the wall, playing on his iPad. He's known to be a fan of Steve Jobs.

You can see Mr. DK here.

>talk to mr dk
Mr. DK looks busy. You shouldn't bother him unless it's something worthwhile.

>take ipad
You can't see any such thing.

>steal ipad
That's not a verb I recognise.

>e
Marketplace
You are in the center of the Marketplace. Look around to see where you want to go.

* * *

>se
Garden
Ms. Baker is an elderly old woman who takes are of her garden as if it were a newborn baby. She's a frail lady, and often needs help with errands.

You can see Ms. Baker here.

>e
You can't go that way.

>w
You can't go that way.

* * *

>e
You can't go that way.

>nw
Marketplace
You are in the center of the Marketplace. Look around to see where you want to go.

* * *

>e
Flower Vendor
Mr. Florence has run the vending cart for as long as you've lived here.

Mr. Florence is refilling the water for some of the flowers.

You can also see Wildflowers, Azaleas, Pink Lilies, White Lilies, Daffodils, Irises, Jasmine Blossoms, Marigolds and Daisies here.

>x flowers
Which do you mean, Bushels of Flowers or Different Flowers?

>bushels
There are: wildflowers, azaleas, pink and white lilies, daffodils, irises, jasmine blossoms, marigolds, and daisies. Each dozen costs a Two-Coin Piece.

>buy pink and white lilies
You can't use multiple objects with that verb.

>buy pink lilies
Why don't you try to take that instead.

>take pink lilies
You can't steal that! It costs a Two-Coin Piece.

>use two coin piecw
That's not a verb I recognise.

>use nine coin piece
That's not a verb I recognise.

>w
Marketplace
You are in the center of the Marketplace. Look around to see where you want to go.

>s
Appliance Store
The Appliance Store is small and rarely has anything in stock. You can look for an item, but it's probalby not in stock. As you enter the store, a cardboard cutout of Steve Jobs greets you.

>look for ipad
It looks like they're out of iPads.

>look for iphone
You can't see any such thing.

>take steve jobs
You can't steal that! The Steve Job cutout costs a Ten Coin Piece. Perhaps you have the money in the bank.

>s
You didn't know the Tack Shop existed until today. You hadn't really ever had the need for horse-stuff. But perhaps there was something useful here. You see a sales associate.

>talk to sales associate
"Umm, hey," you say, walking up to the sales associate. She looks up at you.

"Can I help you with something?" She says curtly. "Yes, actually. I'm looking to buy a saddle and a bridle."

"That's going to cost around 200CP. Do you have that kind of money?" You shake your head. "Go away, then. Come back when you're serious." She stomps to the back of the room. Put off, you return to the marketplace.

Marketplace
You are in the center of the Marketplace. Look around to see where you want to go.

>sw
You climb the stone steps and enter the bank, looking around. The teller looks up at you.

>talk to teller
Hello, I'm Wade-"

"I know who you are. Do you have your key?" You rummage through your pockets, but come up empty. "No, I must have dropped it in the park or something." The teller is unamused. "I can't open your vault unless you have the key. Come back after you find it."

>ne
Marketplace
You are in the center of the Marketplace. Look around to see where you want to go.

>w
School
The school is small, but you have good memories from it. You can see your computer science teacher, Mr. DK, leaning against the wall, playing on his iPad. He's known to be a fan of Steve Jobs.

You can see Mr. DK here.

>nw
You can't go that way.

>e
Marketplace
You are in the center of the Marketplace. Look around to see where you want to go.

>nw
General Store
The General Store was here first. It has several little things on the front desk.

>x front desk
On the counter are many different boxes selling little things: matches, lighters, and town maps.

>take maps
You can't steal this! It costs a Five Coin Piece. Perhaps you have some money in the bank.

>se
Marketplace
You are in the center of the Marketplace. Look around to see where you want to go.

>w
School
The school is small, but you have good memories from it. You can see your computer science teacher, Mr. DK, leaning against the wall, playing on his iPad. He's known to be a fan of Steve Jobs.

You can see Mr. DK here.

* * *

>e
Marketplace
You are in the center of the Marketplace. Look around to see where you want to go.

>ne
Park
A lovely little park. It has a few tall trees and a picnic bench. It looks like someone abandoned their picnic here.

>x picnic bench
I only understood you as far as wanting to examine the Picnic.

>x picnic
It appears as if a family abandoned their picnic. There's a basket, some trash, and the tablecloth.

>x basket
You open the lid of the picnic basket to reveal an untouched cheesecake.

>eat cheesecake
(first taking Cheesecake)
You look over your shoulder to make sure no one is around, and take the cheesecake.

>x trash
There are several empty plastic sandwich bags and a couple forks.

>take forks
For some reason you decide that used forks could be useful to you, and you pick them up.

>x tablecloth
A standard red-and-white checkered picnic blanket.

>take blanket
You can't see any such thing.

>take picnic blanket
I only understood you as far as wanting to take the Picnic.

>take tablecloth
You fold up the blanket and throw it over your shoulder. As you do so, a key falls out from between the folds.

>take key
You already have that.

>sw
Marketplace
You are in the center of the Marketplace. Look around to see where you want to go.

>w
School
The school is small, but you have good memories from it. You can see your computer science teacher, Mr. DK, leaning against the wall, playing on his iPad. He's known to be a fan of Steve Jobs.

You can see Mr. DK here.

* * *

>e
Marketplace
You are in the center of the Marketplace. Look around to see where you want to go.

>sw
You climb the stone steps and enter the bank, looking around. The teller looks up at you.

>talk to teller
"Hello, I'm Wade-"

"I know who you are. Do you have your key?" You rummage through your pockets and pull out the key you found at the park. "Ah, very good, sir. Right this way." The teller leads you to your vault, "vault 316," then returns to the front of the bank.

>open vault
It seems to be locked.

>open vault with ke
You can't see any such thing.

>open vault with key
You unlock Vault 316.

>open vault
You open Vault 316, revealing One Coin Piece, One And A Half Coin Piece, Two-Coin Piece, Two And A Half Coin Piece, Three Coin Piece, Five Coin Piece and Ten Coin Piece.

>take all
Vault 316: Taken.
One Coin Piece: Taken.
One And A Half Coin Piece: Taken.
Two-Coin Piece: Taken.
Two And A Half Coin Piece: Taken.
Three Coin Piece: Taken.
Five Coin Piece: Taken.
Ten Coin Piece: Taken.

>ne
Marketplace
You are in the center of the Marketplace. Look around to see where you want to go.

>s
Appliance Store
The Appliance Store is small and rarely has anything in stock. You can look for an item, but it's probalby not in stock. As you enter the store, a cardboard cutout of Steve Jobs greets you.

>n
Marketplace
You are in the center of the Marketplace. Look around to see where you want to go.

>nw
General Store
The General Store was here first. It has several little things on the front desk.

>take map
You can't see any such thing.

>x front desk
On the counter are many different boxes selling little things: matches, lighters, and town maps.

I beg your pardon?

>take maps
A map costs a Five Coin Piece. Purchase?

>yes
You hand over the coin in exchange for the map.

>x map
General Store: NW. Italian Bistro: N. Park: NE. Forest: NE of Park. Flower Vendor: E. Garden: SE. Appliance Store: S. Tack Shop: S of Appliance Store. Bank: SW. School: W.

>se
Marketplace
You are in the center of the Marketplace. Look around to see where you want to go.

* * *

>e
Marketplace
You are in the center of the Marketplace. Look around to see where you want to go.

>s
Appliance Store
The Appliance Store is small and rarely has anything in stock. You can look for an item, but it's probalby not in stock. As you enter the store, a cardboard cutout of Steve Jobs greets you.

>take steve jobs
The cutout of Steve Jobs costs a Ten Coin Piece. Purchase?

>yes
You buy the cutout. Perhaps you should gift it; Elily isn't a Mac fan.

>n
Marketplace
You are in the center of the Marketplace. Look around to see where you want to go.

>x maps
You can't see any such thing.

>w
School
The school is small, but you have good memories from it. You can see your computer science teacher, Mr. DK, leaning against the wall, playing on his iPad. He's known to be a fan of Steve Jobs.

You can see Mr. DK here.

>give steve jobs
(to Mr. DK)
"Hey, Mr. DK," you say stepping up to him. "I saw this in the store, and I thought you might like it for your classroom, or something." You hand over the cardboard cutout.

"Oh, thank you, Wade." Mr. DK says, accepting the cutout. "This really does look like him." Mr. DK then looks both ways, and leans closer to you. "Now, Wade, I think this guarantees you an A on your project." You laugh nervously.

"Oh Mr. DK, I'll still put the work in, but thanks."

[Your score has just gone up by twenty points.]

>give up life
You can't see any such thing.

>die
That's not a verb I recognise.

>jump in front of car
I only understood you as far as wanting to jump.

>jump off cliff
I only understood you as far as wanting to jump.

>e
Marketplace
You are in the center of the Marketplace. Look around to see where you want to go.

>x map
General Store: NW. Italian Bistro: N. Park: NE. Forest: NE of Park. Flower Vendor: E. Garden: SE. Appliance Store: S. Tack Shop: S of Appliance Store. Bank: SW. School: W.

>e
Flower Vendor
Mr. Florence has run the vending cart for as long as you've lived here.

Mr. Florence is refilling the water for some of the flowers.

You can also see Wildflowers, Azaleas, Pink Lilies, White Lilies, Daffodils, Irises, Jasmine Blossoms, Marigolds and Daisies here.

>take pink lilies
Pink Lilies cost a Two-Coin Piece. Purchase?

>yes
Taken.

>talk to mr florence
"Hey, Mr. Florence," you say with a smile. "How are the flowers doing?"

 "Oh hello there, young sport!" Mr. Florence exclaims. "The flowers are as wonderful as ever," he beams, bouncing on the balls of his feet. "It's been cooler lately, so they're staying fresh longer."

You smile and nod, examining the vibrant colors.

"Are you looking for something in particular?"

>yes
"Actually, yes. I would like to pick something up for my girlfriend." Mr. Florence gives you a knowing smile.

"Do you have a particular flower in mind?"

>yes
"Ah, I'm sure you do! Take them, then, dear fellow, and brighten your lady's day!"

>no
That was a rhetorical question.

>undo
Flower Vendor
[Previous turn undone.]

>no
That was a rhetorical question.

* * *

>undo
Flower Vendor
[Previous turn undone.]

>undo
Flower Vendor
[Previous turn undone.]

* * *

>no
That was a rhetorical question.

>w
Marketplace
You are in the center of the Marketplace. Look around to see where you want to go.

>x map
General Store: NW. Italian Bistro: N. Park: NE. Forest: NE of Park. Flower Vendor: E. Garden: SE. Appliance Store: S. Tack Shop: S of Appliance Store. Bank: SW. School: W.

>look n
You see a cozy Italian Bistro; it's where everyone goes to talk.

* * *

>look ne
You spy the park; you and Elily used to have picnics there.

>e
Flower Vendor
Mr. Florence has run the vending cart for as long as you've lived here.

Mr. Florence is refilling the water for some of the flowers.

You can also see Wildflowers, Azaleas, White Lilies, Daffodils, Irises, Jasmine Blossoms, Marigolds and Daisies here.

>w
Marketplace
You are in the center of the Marketplace. Look around to see where you want to go.

>se
Garden
Ms. Baker is an elderly old woman who takes are of her garden as if it were a newborn baby. She's a frail lady, and often needs help with errands.

You can see Ms. Baker here.

>talk to ms baker
"Oh, Wade, I'm so glad you're here. Can you run over to the Park and get my picnic blanket? I forgot it there earlier."
You hand over the picnic blanket. "Here you are, Ms. Baker."

"Oh, thank you. So very helpful of you. Here, for your troubles." She hands you a four coin piece.

>talk to ms baker
"Anything else I can do for you, Ms. Baker?" 

"Oh, I'm alright for now, sweety. You've been very helpful though, as always. Here, have something extra- get something for Elily." She hands you a seven coin piece.

>ne
You can't go that way.

>n
You can't go that way.

>nw
Marketplace
You are in the center of the Marketplace. Look around to see where you want to go.

* * *

>n
Italian Bistro
The Bistro is the coffee and social hub of the town. Everyone gathers here for a bite to eat, something to drink, or to just talk to the other townspeople. There are menus hanging over the counter, scattered round tables, and a brown sofa.

You can see Mr. Mason and Hayden here.

>talk to hayden
You look at Hayden, but he ignores you and your abscence of Curry Chicken Salad.

>take curry chicken salad
Curry Chicken Salad costs a Seven Coin Piece. Purchase?

>yes
You hand over the coin in exchange for the pizza.

>talk to hayden
You hand over the salad.

Hayden takes a bite. "Delicious."

"Hayden. This animal?"

"Ah. She is beautiful, Wade."

"What is she? How would I even train her?"

"She is a unicorn, Wade. A beautiful, beautiful unicorn. She's very special to me." You stare at the man, appalled. A unicorn? Those didn't exist! "Oh Wade, so naive. They do exist. Go find her, Wade. She will take you to a wonderful place. There, you will be able to find something worthy for Elily." You stare at the man speechlessly  He takes another bite of soup.

"Okay, Hayden. Let's say I believe you. How would I even tame her?" Hayden became quiet. He turns and his eyes lock with yours. You're too scared to break the connection.

"She is very special to me, Wade. You cannot speak of her to a single soul. Or anything soulless, for that matter. Understood?" You nod hastily. The tension dissipates and Hayden picks his plate back up. "Just make your way down to the Tack Shop, it's south of the Appliance Store. Talk to the sales associate there." You nod, still trying to process what you just learned. You couldn't make yourself believe that there was actually a unicorn in the forest, but you couldn't resist looking. "Oh- Wade. You'll need this." Hayden hands you a 200CP, and returns to his meal.

>s
Marketplace
You are in the center of the Marketplace. Look around to see where you want to go.

>look s
A small Appliance Store.

>s
Appliance Store
The Appliance Store is small and rarely has anything in stock. You can look for an item, but it's probalby not in stock. As you enter the store, a cardboard cutout of Steve Jobs greets you.

>s
You didn't know the Tack Shop existed until today. You hadn't really ever had the need for horse-stuff. But perhaps there was something useful here. You see a sales associate.

>talk to sales associate
"Umm, hey," you say, walking up to the sales associate. She looks up at you.

"Can I help you with something?" She says curtly.

"Yes, actually. I'm looking to buy a saddle and a bridle."

"Yeah, how specific."

"Pardon?"

"Nothing. Here, let me just go grab some." She marches off in a huff, leaving you standing next to horse mannequins and a mini-fridge of carrots.

She returns with a simple black leather bridal over her shoulder and a saddle on her hip. "This work for you, kid?"

"Yeah, I suppose." She rings them up. "I'm going to give you these carrots for free, too. That'll be 200CP."

"Oh, okay." She hands the items to you and you struggle to hold them all. She snorts a laugh, and walks to the other side of the room.

>n
Appliance Store
The Appliance Store is small and rarely has anything in stock. You can look for an item, but it's probalby not in stock. As you enter the store, a cardboard cutout of Steve Jobs greets you.

>n
Marketplace
You are in the center of the Marketplace. Look around to see where you want to go.

>n
Italian Bistro
The Bistro is the coffee and social hub of the town. Everyone gathers here for a bite to eat, something to drink, or to just talk to the other townspeople. There are menus hanging over the counter, scattered round tables, and a brown sofa.

You can see Mr. Mason and Hayden here.

* * *

>talk to hayden
You look at Hayden, but he ignores you and your abscence of Curry Chicken Salad.

>s
Marketplace
You are in the center of the Marketplace. Look around to see where you want to go.

>x map
General Store: NW. Italian Bistro: N. Park: NE. Forest: NE of Park. Flower Vendor: E. Garden: SE. Appliance Store: S. Tack Shop: S of Appliance Store. Bank: SW. School: W.

>ne
Park
A lovely little park. It has a few tall trees and a picnic bench. It looks like someone abandoned their picnic here.

>ne
You have no idea where the unicorn could be, and the trails are all a maze. You better start looking.

Forest
The forest is criss-crossed with hiking and biking trails. It's a nice place to go for a walk.

>walk
You'll have to say which compass direction to go in.

>n
Main Trail
You step onto the main trail. To the west, is the first trail. To the north, the main trail continues on.

>w
FirstTrail
You turn west onto the first trail. You continue along until you come to a dead end. You can either go back, or turn south.

>s
You can't go that way.

>turn south
You must name something more substantial.

>e
Main Trail
You step onto the main trail. To the west, is the first trail. To the north, the main trail continues on.

>w
FirstTrail
You turn west onto the first trail. You continue along until you come to a dead end. You can either go back, or turn south.

>e
Main Trail
You step onto the main trail. To the west, is the first trail. To the north, the main trail continues on.

>n
Main Trail
You continue onto the main trail, and see the second trail to the east.

>e
SecondTrail
You turn east onto the second trail. You hit a fork. You can either go north, or south.

>n
T2-0
You turn north. You hit a dead end.

>s
SecondTrail
You turn east onto the second trail. You hit a fork. You can either go north, or south.

>s
T2-1
You turn south. You hit a dead end. You can turn east.

>e
T2-2
You turn east, and continue along the trail. You come across a turn to the south. You can turn, or continue east.

>s
T2-3
You turn south, and hit a dead end. You can turn east.

>e
T2-3-1
You turn east and hit a dead end. You can turn south.

>w
T2-3
You turn south, and hit a dead end. You can turn east.

>e
T2-3-1
You turn east and hit a dead end. You can turn south.

>s
T2-3-2
You turn south and hit a dead end. You can turn east.

>n
T2-3-1
You turn east and hit a dead end. You can turn south.

>s
T2-3-2
You turn south and hit a dead end. You can turn east.

* * *

>n
T2-3-1
You turn east and hit a dead end. You can turn south.

>w
T2-3
You turn south, and hit a dead end. You can turn east.

>s
You can't go that way.

>w
You can't go that way.

>e
T2-3-1
You turn east and hit a dead end. You can turn south.

* * *

>n
T2-3-1
You turn east and hit a dead end. You can turn south.

>e
You can't go that way.

>w
T2-3
You turn south, and hit a dead end. You can turn east.

* * *

>s
T2-3-2
You turn south and hit a dead end. You can turn east.

>e
T2-3-3
You turn east. You hit a dead end. You can turn north.

>w
T2-3-2
You turn south and hit a dead end. You can turn east.

>e
T2-3-3
You turn east. You hit a dead end. You can turn north.

>n
T2-3-4
You turn north and hit a dead end. You can turn east.

>s
T2-3-3
You turn east. You hit a dead end. You can turn north.

>n
T2-3-4
You turn north and hit a dead end. You can turn east.

>e
T2-3-5
You turn east and hit a dead end. You can go south.

>s
T2-3-6
You turn south and hit a dead end. You can go west.

>w
T2-3-7
You turn west and hit a dead end.

>e
T2-3-6
You turn south and hit a dead end. You can go west.

>n
T2-3-5
You turn east and hit a dead end. You can go south.

>w
T2-3-4
You turn north and hit a dead end. You can turn east.

>s
T2-3-3
You turn east. You hit a dead end. You can turn north.

>w
T2-3-2
You turn south and hit a dead end. You can turn east.

>s
You can't go that way.

>s
You can't go that way.

I beg your pardon?

>s
You can't go that way.

>sn
That's not a verb I recognise.

>n
T2-3-1
You turn east and hit a dead end. You can turn south.

>ww
That's not a verb I recognise.

>w
T2-3
You turn south, and hit a dead end. You can turn east.

>n
T2-2
You turn east, and continue along the trail. You come across a turn to the south. You can turn, or continue east.

>e
T2-2-1
You continue east and hit a dead end. You can turn north.

>w
T2-2
You turn east, and continue along the trail. You come across a turn to the south. You can turn, or continue east.

>e
T2-2-1
You continue east and hit a dead end. You can turn north.

>gonear maintrail1
Main Trail
You step onto the main trail. To the west, is the first trail. To the north, the main trail continues on.

>n
Main Trail
You continue onto the main trail, and see the second trail to the east.

>n
Main Trail
You continue north along the main trail. Two trails turn off: one to the east and one to the west. The main trail continues north.

>n
Main Trail
You continue north along the main trail. The fifth trail turns off to the west.

>w
FifthTrail
You turn west onto the fifth trail. A trail turns off to the north. You can also continue west.

>w
T5-2
You continue west and hit a dead end. You can turn south.

>s
T5-3
You turn south. A trail turns off to the west, or you can continue south.

>s
T5-4
You continue south and hit a dead end. You can turn east.

>e
T5-5
You turn east and hit a dead end. You can turn north.

>n
T5-6
You turn north and hit a dead end. You can turn east.

>e
T5-7
You turn east and hit a dead end.

>e
You can't go that way.

>gonear fifthtrail
FifthTrail
You turn west onto the fifth trail. A trail turns off to the north. You can also continue west.

>w
T5-2
You continue west and hit a dead end. You can turn south.

* * *

>s
T5-3
You turn south. A trail turns off to the west, or you can continue south.

>w
T5-3-1
You turn west and hit a dead end. You can turn south.

>s
T5-3-2
You turn south and hit a dead end. You can turn east.

>e
T5-3-3
You turn east and hit a dead end. You can turn south.

>s
T5-3-4
You turn south and hit a dead end. You can turn west.

>w
T5-3-5
You hit a dead end. You can turn north.

>n
T5-3-6
You turn north and hit a dead end. You can turn west.

>w
T5-3-7
You turn west and stumble into a clearing. There's a small pond and nibbling at the grass around it is a glistening silver unicorn. You move towards the unicorn. She spies you, and whips her head up in alert. You halt instantly, not wanting to scare her away. "Hey, pretty girl," you say, and reach for a carrot. She watches you intently. You hold the carrot out. "Hey girl, do you want a treat?" She paws at the ground. You take another step forward. Then another. And another. Finally, your outstretched arm holding the carrot is just infront of her head. She reaches forward, and takes the carrot. You give her another.

You can see Unicorn here.

>ride unicorn
"Hey, beautiful. Wow. I can't believe this is real."

"Hayden said you were coming," says a bell-like voice in your head. You nearly fall off the unicorn. "You're so silly," the voice continues. "My name is Amara." You look down at your mount.

"Are you the unicorn?" The bell-like voice chimes a laugh in your head.

"Yea, I am. So, I hear that we have somewhere special to go!"

You cannot ride her without a saddle.

>put saddle on unicorn
You offer the unicorn another carrot, and while she is chewing you throw the saddle over her back. She doesn't seem to mind, as if this is nothing new. Her muzzle pushes into your pocket, looking for more carrots.

>ride unicorn
You cannot ride her without a bridle.

>put bridle on unicorn
You stroke the unicorn's neck, then slip the bridle over her head. She protests a little, but gives in quickly. She doesn't seem to mind much, as if this is nothing new.

>ride unicorn
You step forward, and mount the unicorn.

>ride unicorn
You step forward, and mount the unicorn.

* * *

>x tent
A rather nice two-person tent that you borrowed from your cousin for the weekend.

>take tent
That's hardly portable.

>x cooler
The cooler contains Bottles.

>open cooler
You open the cooler, revealing Bottles.

* * *

>take bottles
Taken.

>x bottles
You see nothing special about Bottles.

>x backpack
A simple bag that's seen better days. Nevertheless, you managed to stuff it with necessities and bring it on the trip.

* * *

>open backpack
You open the backpack, revealing a lighter, a candle and a flashlight.

>take all
backpack: Taken.
lighter: Taken.
candle: Taken.
flashlight: Taken.

>x lighter
A half-full, blue, dollar-store plastic lighter.

The lighter is currently switched off.

[Your score has just gone up by one point.]

>x candle
A scentless candle capable of a tiny and weak flame.

The candle is currently switched off.

[Your score has just gone up by one point.]

>x flashlight
A small silver flashlight.

The flashlight is currently switched off.

[Your score has just gone up by one point.]

>l
Campfire
It's night, but the fire just burned out and you both are getting cold. Your tent is in a grassy clearing. To the north are the woods, to the east a stream, and the west a rocky cliff. A mysterious cabin is to your south. In your tent there's a cooler, a backpack, and two sleeping bags.

You can see a cooler (empty) and sleeping bags here.

>x sleeping bags
Two army-green sleeping bags. They're very warm and clean, but aren't in the best physical condition due to years of use.

>n
It's dark outside. Are you sure?

* * *

>turn on flashlight
You switch the flashlight on.

>n
Woods
You venture outside towards the woods. You can hear the branches creaking and laughing at your misfortune. Somewhere, an owl hoots a solemn tune before being abruptly cut off. You shiver both from the cold and from the darkness. Tangled in the thorny holly trees are the dead branches of their taller brothers.

You can see a holly tree (on which is Branches) here.

* * *

>x owl
You can't see the bird, but the echo of its last half-"hoot" rings in your ears.

>x holly tree
You step closer and trip into the thorns, scratching your arms and snagging your shirt. It's dark, cold, and windy. Is this really the best time and place to leave your girl alone?

On the holly tree is Branches.

[Your score has just gone up by one point.]

>take branches
Taken.

>x dead branches
You can't see any such thing.

>s
Campfire
It's night, but the fire just burned out and you both are getting cold. Your tent is in a grassy clearing. To the north are the woods, to the east a stream, and the west a rocky cliff. A mysterious cabin is to your south. In your tent there's a cooler, a backpack, and two sleeping bags.

You can see a cooler (empty) and sleeping bags here.

>light fire with lighter
You can't see any such thing.

>light branches with lighter
You can't see any such thing.

>light branches
[Your score has just gone up by one point.]

>spark lighter
You switch the lighter on.

>extinguish lighter
You switch the lighter off.

>w
You cautiously make your way to the edge of the cliff and peer over. Unfortunately, you lose your footing and fall.

    *** You have died ***

In that game you scored 5 out of a possible 0, in 25 turns.

Would you like to RESTART, RESTORE a saved game, QUIT or UNDO the last command?

>undo
Campfire
[Previous turn undone.]

>e
Within a few dozen paces you arrive at the stream.

>l
Stream
Just a simple, medium-speed crick.

>x stream
You can't see any such thing.

>x crick
Cold and (hopefully) clean.

>take water
You dip the mouth of each bottle into the stream until they are full of water.

>x
What do you want to examine?

>i
You are carrying:
  Bottled water
  Branches
  a flashlight
  a candle
  a lighter
  a backpack (open but empty)

>w
Campfire
It's night, but the fire just burned out and you both are getting cold. Your tent is in a grassy clearing. To the north are the woods, to the east a stream, and the west a rocky cliff. A mysterious cabin is to your south. In your tent there's a cooler, a backpack, and two sleeping bags.

You can see a cooler (empty) and sleeping bags here.

* * *

>drink water
The water tastes fine to you, so you give your girlfriend a reassuring smile. She takes a sip.

[Your score has just gone up by one point.]

>d
You can't go that way.

>s
Brandishing your faithful flashlight you cautiously make your way to the spooky old abandoned cabin you passed on your way to the camping location. Wind rushes through the top of the nearby woods and over your head, only to plummet down the rocky cliff. The cabin looms before you. There's an outhouse to the east.

>s
The door is locked.

(first opening the oak door)
It seems to be locked.

>l
cabin
It appears to be a small cabin with an outhouse to the east. The windows are boarded up and the oak door looks solid.

You can see an oak door and a Master lock here.

>x windows
Intact glass windows are jailed behind cris-crossing wooden planks. This doesn't seem like a plausible entryway.

[Your score has just gone up by one point.]

>x door
The door is made of old, thick oak planks and has an iron cage over the peephole. A bullet is lodged to the right of the bars.  A simple Master lock keeps the door closed.

>x bullet
A spent .45

>x lock
 A simple lock with a key broken off inside. It looks like you'll have to look around for something to break it.

>e
Outhouse
You arrive at an old wooden outhouse. You notice an overturned wheelbarrow behind it. With a heavy push the door gives way to a small room full of stale air and forgotten spiderwebs. Up on a shelf is a toolbox. At your feet lies a trapdoor and the toilet function is nestled in the corner to your right.

You can see a trapdoor here.

* * *

>x toolbox
A standard old toolbox covered in dark stains that you can't make out in your flashlight's feeble beam.

[Your score has just gone up by one point.]

>open toolbox
The toolbox is locked shut. It doesn't seem like you'll find anything in it, anyway.

>l
Outhouse
You arrive at an old wooden outhouse. You notice an overturned wheelbarrow behind it. With a heavy push the door gives way to a small room full of stale air and forgotten spiderwebs. Up on a shelf is a toolbox. At your feet lies a trapdoor and the toilet function is nestled in the corner to your right.

You can see a trapdoor here.

>x toilet
A crude replication of the luxury you use at home.

[Your score has just gone up by one point.]

>x trapdoor
A standard trapdoor with a steel ring and everything.

[Your score has just gone up by one point.]

>d
(first opening the trapdoor)
Are you sure? Remember, you are in an outhouse.

>y
Against your better judgement you lift the knarly trapdoor and make your way down the rickety ladder into a pit of darkness. The air is damp and reeks of mildew. Your flashlight cuts out and your foot lands on something crunchy.

That's already open.

hole
You drop down into a dark hole. The blackness is extreme, and you have no idea how large the room is. It looks like one giant shadow.

You can see a trapdoor here.

>x trapdoor
A standard trapdoor with a steel ring and everything.

>x blackness
Complete and utter darkness.

>x wall
You reach out, feeling up and down the crumbling walls of the hole. In some places the dirt is sticky and wet. Your hands come into contact with a box. It's made of metal and cold to the touch.

[Your score has just gone up by five points.]

>x box
You can't see it, but it appears to be a cast iron safe.

>open
What do you want to open?

>open box
The door to the safe takes a few tugs before it begrudgingly opens. You can't see what's inside, but you're sure there must be something.

>take all
Rose: [Your score has just gone up by two points.]

>u
You clamber desperately back up the rotting rope ladder. Your flashlight flickers back to life.

>l
Outhouse
You arrive at an old wooden outhouse. You notice an overturned wheelbarrow behind it. With a heavy push the door gives way to a small room full of stale air and forgotten spiderwebs. Up on a shelf is a toolbox. At your feet lies a trapdoor and the toilet function is nestled in the corner to your right.

You can see a trapdoor here.

>x wheelbarrow
Holding your flashlight with two hands, like a sword, you make your way to an old overturned wooden wheelbarrow.

Small plants had made their homes between the cracks in the wood and cast eerie shadows across the ground. Here you find a hammer.

* * *

>take hammer
Taken.

>x shadows
The shadows won't hold still long enough for you to tell what they're of; but your subconcious has already decided they're ghosts and mutant monsters.

>w
cabin
It appears to be a small cabin with an outhouse to the east. The windows are boarded up and the oak door looks solid.

You can see an oak door and a Master lock here.

>x lock
 A simple lock with a key broken off inside. It looks like you'll have to look around for something to break it.

>break lock with hammer
The head of the hammer thuds into the lock with a dull *clink* and breaks it.

* * *

>x lock
A broken lock. It's worth no more than the metal it's made of.

>open door
You open the oak door.

>enter
You must supply a noun.

>enter cabin
You can't see any such thing.

>s
cabin interior
The room consists of a solitary sofa infront of a fireplace, and a kitchenette.

You can see an oak door and a kitchenette here.

>x oak door
The door is made of old, thick oak planks and has an iron cage over the peephole. A bullet is lodged to the right of the bars.  Pieces of a broken lock dangle uselessly.

>x sofa
A disgrace to the "70"s, but nevertheless a sofa from that time. The ugly floral pattern is fadded and the cloth on the arm wrests is worn through.

[Your score has just gone up by one point.]

* * *

>look under sofa
Just a family of dead dust mites.

[Your score has just gone up by two points.]

>take mites
As lovely a gift you think dust would be, I promise you're wrong.

>l
cabin interior
The room consists of a solitary sofa infront of a fireplace, and a kitchenette.

You can see an oak door and a kitchenette here.

* * *

>take ashes
You try desperately to scoop the ashes up, but they fall through your fingers. Don't feel too bad about it, though. I don't really think your girlfriend would think that's a nice present anyway.

>l
cabin interior
The room consists of a solitary sofa infront of a fireplace, and a kitchenette.

You can see an oak door and a kitchenette here.

>x kitchenette
Here you find several dollar-store white plates and a couple cans of soup whose expiration dates haven't yet been reached.

>x plates
Ten milky-white, cheap plates. The skeletons of dead bugs are solidified to their surfaces.

[Your score has just gone up by one point.]

* * *

>take bugs
You can't see any such thing.

>take dead bugs
You can't see any such thing.

>x soup
Just simple store-brand chicken noodle soup.

[Your score has just gone up by one point.]

>take soup
Taken.

>eat soup
How rude! Remember, this is for you AND your girlfriend.

[Your score has just gone up by one point.]

>n
cabin
It appears to be a small cabin with an outhouse to the east. The windows are boarded up and the oak door looks solid.

You can see an oak door and a Master lock here.

* * *

>n
Campfire
It's night, but the fire just burned out and you both are getting cold. Your tent is in a grassy clearing. To the north are the woods, to the east a stream, and the west a rocky cliff. A mysterious cabin is to your south. In your tent there's a cooler, a backpack, and two sleeping bags.

You can see a cooler (empty) and sleeping bags here.

>eat soup
The soup singes your tongue, but you're grateful. You fear if it was cooler you'd be able to taste the cabin in it. (I hope you have something to wash this down!)

You survived the camping trip! However, your girlfriend isn't very happy with you. You promised her a wonderful weekend, but there was literally nothing wonderful about it. You fed her sketchy soup that you stole from a cabin that you broke into, for heaven's sake!
But that was last weekend. It's Saturday morning, and you're in the Marketplace. You want to make it up to your girl, but you're not quite sure how. I guess the first thing would be to stop calling her "girl" or "girlfriend". She has a name. It's Elily. Now, look around. Maybe you'll see something to inspire you. (remember, NW, SW, NE and SE are directions)
Marketplace
You are in the center of the Marketplace. Look around to see where you want to go. If you get lost, head over to the General Store for a map.

[Your score has just gone up by one point.]

>ne
Park
A lovely little park. It has a few tall trees and a picnic bench. It looks like someone abandoned their picnic here.

>x picnic
It appears as if a family abandoned their picnic. There's a basket, some trash, and the tablecloth.

* * *

>x basket
You open the lid of the picnic basket to reveal an untouched cheesecake.

>x cheesecake
It looks fancy! The sticker says "Fruit Sampler (strawberry, cherry, pineapple, blueberry)".

>eat cheesecake
(first taking Cheesecake)
You look over your shoulder to make sure no one is around, and take the cheesecake.

>i
You are carrying:
  Fancy-Cheesecake
  Wallet (closed)

>eat cheesecake
You can't see any such thing.

>eat fancy-cheesecake
You eat Fancy-Cheesecake. Not bad.

>l
Park
A lovely little park. It has a few tall trees and a picnic bench. It looks like someone abandoned their picnic here.

>x picnic
It appears as if a family abandoned their picnic. There's a basket, some trash, and the tablecloth.

>x trash
There are several empty plastic sandwich bags and a couple forks.

>take all
(Wallet)
You already have that.

>take bags
You pick up the bags and stuff them in your pockets. You don't condone littering.

>take forks
For some reason you decide that used forks could be useful to you, and you pick them up.

* * *

>x tablecloth
A standard red-and-white checkered picnic blanket.

>take tablecloth
You fold up the blanket and throw it over your shoulder. As you do so, a key falls out from between the folds.

* * *

>take key
You already have that.

>l
Park
A lovely little park. It has a few tall trees and a picnic bench. It looks like someone abandoned their picnic here.

>x trees
Which do you mean, Tall Trees or Black Cherry Trees?

* * *

>tall trees
There are a couple black cherry trees and a willow tree.

>x cherry trees
There are only three of them. Their leaves are smooth and shiny.

>x willow tree
The willow tree is definately the oldest thing in the park. Its long leaves and branches brush the ground, and its trunk is scarred.

>x trunk
The trunk of the willow has been carved in by decades of teenagers. There are hearts with initials as well as curse words.

>x curse words
You look closely, but you see no curse words that you don't already know. Not that it matters, because Elily doesn't like it when you "say bad words".

>x hearts
The most prominent heart contains a "E+A"

>l
Park
A lovely little park. It has a few tall trees and a picnic bench. It looks like someone abandoned their picnic here.

>x bench
A wooden picnic bench.

>take bench
That's hardly portable.

>ne
You don't feel like going for a hike right now, so you return to the park.

Park
A lovely little park. It has a few tall trees and a picnic bench. It looks like someone abandoned their picnic here.

>sw
Marketplace
You are in the center of the Marketplace. Look around to see where you want to go. If you get lost, head over to the General Store for a map.

>e
Flower Vendor
Mr. Florence has run the vending cart for as long as you've lived here.

Mr. Florence is refilling the water for some of the flowers.

You can also see Wildflowers, Azaleas, Pink Lilies, White Lilies, Daffodils, Irises, Jasmine Blossoms, Marigolds and Daisies here.

>x pink lilies
A six petaled flower that is dark pink down the center of each petal. The pink fades to white by the end of the petal.

>x daisies
A beautiful and simple flower with a yellow center and many slender long white petals.

>talk to mr. florence
"Hey, Mr. Florence," you say with a smile. "How are the flowers doing?"

 "Oh hello there, young sport!" Mr. Florence exclaims. "The flowers are as wonderful as ever," he beams, bouncing on the balls of his feet. "It's been cooler lately, so they're staying fresh longer."

You smile and nod, examining the vibrant colors.

"Are you looking for something in particular?"

>no
"No, I'm just browsing."

Mr. Florence nods. "Let me know if you need anything!"

That was a rhetorical question.

>talk to florence
"Hey again, Mr. Florence." 

"Oh hello, there. Do you know what you would like yet?"

>yes
"Ah, I'm sure you do! Take them, then, dear fellow, and brighten your lady's day!

* * *

I beg your pardon?

>take flowers
Which do you mean, Bushels of Flowers or Different Flowers?

>l
Flower Vendor
Mr. Florence has run the vending cart for as long as you've lived here.

Mr. Florence is refilling the water for some of the flowers.

You can also see Wildflowers, Azaleas, Pink Lilies, White Lilies, Daffodils, Irises, Jasmine Blossoms, Marigolds and Daisies here.

>x vending cart
A rather nice wooden cart with metal supports. Bushels of flowers are gathered in dozens along the cart's shelves.

>x bushels
There are: wildflowers, azaleas, pink and white lilies, daffodils, irises, jasmine blossoms, marigolds, and daisies. Each dozen costs a Two-Coin Piece.

>take marigolds
You can't steal that! It costs a Two-Coin Piece.

>w
Marketplace
You are in the center of the Marketplace. Look around to see where you want to go. If you get lost, head over to the General Store for a map.

>se
Garden
Ms. Baker is an elderly old woman who takes are of her garden as if it were a newborn baby. She's a frail lady, and often needs help with errands.

You can see Ms. Baker here.

>talk to baker
"Hey, Ms. Baker. How are you?" You say laoudly as you approach the older woman. She looks up and beams at you.

"Wade! It's so nice to see you again!" She brushes her hands off on her apron and gives you a hug. "I'm doing just fine, sweety."

"Well, I'm very glad to hear that, Ms. Baker. Is there anything I can help you with?"

"Hmm," she says as she puts her left hand on her hip. "Actually, there is. Do you think that you could take this crate of vegetables to Mr. Mason in the Italian Bistro? Make sure to bring back the check he gives you, and I'll have something special for you." She leads you to a wooden crate. With a grunt, you pick it up.

"Thanks again, dear."

"No problem, Ms. Baker. I'll be right back."

>nw
Marketplace
You are in the center of the Marketplace. Look around to see where you want to go. If you get lost, head over to the General Store for a map.

>s
Appliance Store
The Appliance Store is small and rarely has anything in stock. You can look for an item, but it's probalby not in stock. As you enter the store, a cardboard cutout of Steve Jobs greets you.

>x cutout
You can't see any such thing.

>x steve jobs
A lovely and realistic cardboard cutout image of Steve Jobs. He is wearing glasses, white tennis shoes, a long-sleeved black turtleneck shirt, and blue jeans.

>take steve jobs
You can't steal that! The Steve Job cutout costs a Ten Coin Piece. Perhaps you have the money in the bank.

>n
Marketplace
You are in the center of the Marketplace. Look around to see where you want to go. If you get lost, head over to the General Store for a map.

>sw
You climb the stone steps and enter the bank, looking around. The teller looks up at you.

* * *

>talk to teller
"Hello, I'm Wade-"

"I know who you are. Do you have your key?" You rummage through your pockets and pull out the key you found at the park. "Ah, very good, sir. Right this way." The teller leads you to your vault, "vault 316," then returns to the front of the bank.

>x vault
You see nothing special about Vault 316.

>open vault
It seems to be locked.

>unlock vault with key
You unlock Vault 316.

>open vault
You open Vault 316, revealing One Coin Piece, One And A Half Coin Piece, Two-Coin Piece, Two And A Half Coin Piece, Three Coin Piece, Five Coin Piece and Ten Coin Piece.

>take all
One Coin Piece: Taken.
One And A Half Coin Piece: Taken.
Two-Coin Piece: Taken.
Two And A Half Coin Piece: Taken.
Three Coin Piece: Taken.
Five Coin Piece: Taken.
Ten Coin Piece: Taken.

>i
You are carrying:
  Ten Coin Piece
  Five Coin Piece
  Three Coin Piece
  Two And A Half Coin Piece
  Two-Coin Piece
  One And A Half Coin Piece
  One Coin Piece
  Wooden Crate
  Simple Key
  Picnic Blanket
  Used Forks
  Sandwich Bag
  Wallet (closed)

>ne
Marketplace
You are in the center of the Marketplace. Look around to see where you want to go. If you get lost, head over to the General Store for a map.

>s
Appliance Store
The Appliance Store is small and rarely has anything in stock. You can look for an item, but it's probalby not in stock. As you enter the store, a cardboard cutout of Steve Jobs greets you.

* * *

>yes
You buy the cutout. Perhaps you should gift it; Elily isn't a Mac fan.

>n
Marketplace
You are in the center of the Marketplace. Look around to see where you want to go. If you get lost, head over to the General Store for a map.

>w
School
The school is small, but you have good memories from it. You can see your computer science teacher, Mr. DK, leaning against the wall, playing on his iPad. He's known to be a fan of Steve Jobs.

You can see Mr. DK here.

>talk to mr. dk
Why don't you just give him Steve Jobs? It's going to be weird talking to him holding that giant cutout.

That's not a verb I recognise.

>give steve jobs to mr dk
"Hey, Mr. DK," you say stepping up to him. "I saw this in the store, and I thought you might like it for your classroom, or something." You hand over the cardboard cutout.

"Oh, thank you, Wade." Mr. DK says, accepting the cutout. "This really does look like him." Mr. DK then looks both ways, and leans closer to you. "Now, Wade, I think this guarantees you an A on your project." You laugh nervously.

"Oh Mr. DK, I'll still put the work in, but thanks."

[Your score has just gone up by twenty points.]

>e
Marketplace
You are in the center of the Marketplace. Look around to see where you want to go. If you get lost, head over to the General Store for a map.

>ne
Park
A lovely little park. It has a few tall trees and a picnic bench. It looks like someone abandoned their picnic here.

>sw
Marketplace
You are in the center of the Marketplace. Look around to see where you want to go. If you get lost, head over to the General Store for a map.

>nw
General Store
The General Store was here first. It has several little things on the front desk.

* * *

>x front desk
On the counter are many different boxes selling little things: matches, lighters, and town maps.

>x matches
Several boxes of Stansport Waterproof Matches.

>x lighters
A pastic jar full of green, yellow, orange, blue, red, and white BIC lighters.

>x town maps
A handy piece of paper in the Marketplace. It tells you where everthing is.

>take all
There are none at all available!

>take map
A map costs a Five Coin Piece. Purchase?

>y
You hand over the coin in exchange for a map.

>x map
General Store: NW. Italian Bistro: N. Park: NE. Forest: NE of Park. Flower Vendor: E. Garden: SE. Appliance Store: S. Tack Shop: S of Appliance Store. Bank: SW. School: W.

>ne
You can't go that way.

>se
Marketplace
You are in the center of the Marketplace. Look around to see where you want to go. If you get lost, head over to the General Store for a map.

>n
Italian Bistro
The Bistro is the coffee and social hub of the town. Everyone gathers here for a bite to eat, something to drink, or to just talk to the other townspeople. There are menus hanging over the counter, scattered round tables, and a brown sofa.

You can see Mr. Mason and Hayden here.

>talk to mr mason
"Hey, Mr. Mason?" You say, approaching the manager.

"Yes? Ah," he says, seeing the crate. "Thank you," he says as he takes the crate from you. "Here, be sure to give this to Ms. Baker." He hands you a check and takes the crate to he back of the store.

>i
You are carrying:
  Payment Check
  Town Map
  Three Coin Piece
  Two And A Half Coin Piece
  Two-Coin Piece
  One And A Half Coin Piece
  One Coin Piece
  Simple Key
  Picnic Blanket
  Used Forks
  Sandwich Bag
  Wallet (closed)

>s
Marketplace
You are in the center of the Marketplace. Look around to see where you want to go. If you get lost, head over to the General Store for a map.

>se
Garden
Ms. Baker is an elderly old woman who takes are of her garden as if it were a newborn baby. She's a frail lady, and often needs help with errands.

You can see Ms. Baker here.

>talk to ms baker
"Here, Ms. Baker." You hand over the check.

"Oh, thank you dear! And here's a little something for you." Ms. Baker hands you a nine coin piece.

>talk to ms baker
"Oh, Wade, I'm so glad you're here. Can you run over to the Park and get my picnic blanket? I forgot it there earlier."
You hand over the picnic blanket. "Here you are, Ms. Baker."

"Oh, thank you. So very helpful of you. Here, for your troubles." She hands you a four coin piece.

* * *

>talk to ms baker
"Anything else I can do for you, Ms. Baker?" 

"Oh, I'm alright for now, sweety. You've been very helpful though, as always. Here, have something extra- get something for Elily." She hands you a seven coin piece.

>nw
Marketplace
You are in the center of the Marketplace. Look around to see where you want to go. If you get lost, head over to the General Store for a map.

>n
Italian Bistro
The Bistro is the coffee and social hub of the town. Everyone gathers here for a bite to eat, something to drink, or to just talk to the other townspeople. There are menus hanging over the counter, scattered round tables, and a brown sofa.

You can see Mr. Mason and Hayden here.

>talk to hayden
"Hello, Hayden." You sit down on the sofa next to him. He continues to look into his coffee mug.

"Wade," he acknowledges.

"How do you know my-" Hayden looks up at you. "Never mind." Hayden holds your gaze for another second, then drops it to his mug and takes a sip.

"Anyone can buy a girl flowers, Wade." He says. You become uncomfortable. "I think you should do something a little more special for her, Wade. She's worth more than flowers." You shift in your seat.

"Well, I have other ideas, too-"

"Ah."

"Do you have a better idea, sir?" Hayden chuckles.

"I'm no "sir". But yes. I do. A beautiful girl like Elily? Flowers are silly. Would you like to know of my idea?"

>y
"Ahh, yes. Have you ever been to the forest, Wade? It's just northeast of the park."

"I've biked the trails a time or two, yes."

"There is a wonderful creature, in those trees, Wade. She sparkles and glistens and flies like the wind," his voice trails. "You must find her, Wade. And you must tame her. And she will take you to wonderous places."

"What, what do you mean?" Hayden has completely lost you. "A flying creature that I can tame and ride? What are you talking about." Hayden smiles.

"I'm rather hungry, Wade. Why don't you buy me a Curry Chicken Salad, and we can talk about it."
You continue to look at Hayden, but he ignores you and your abscence of Curry Chicken Salad.

>take curry chicken salad
Curry Chicken Salad costs a Seven Coin Piece. Purchase?

>y
You hand over the coin in exchange for the salad.

>talk to hayden
You hand over the salad.

Hayden takes a bite. "Delicious."

"Hayden. This animal?"

"Ah. She is beautiful, Wade."

"What is she? How would I even train her?"

"She is a unicorn, Wade. A beautiful, beautiful unicorn. She's very special to me." You stare at the man, appalled. A unicorn? Those didn't exist! "Oh Wade, so naive. They do exist. Go find her, Wade. She will take you to a wonderful place. There, you will be able to find something worthy for Elily." You stare at the man speechlessly  He takes another bite of curry.

"Okay, Hayden. Let's say I believe you. How would I even tame her?" Hayden became quiet. He turns and his eyes lock with yours. You're too scared to break the connection.

"She is very special to me, Wade. You cannot speak of her to a single soul. Or anything soulless, for that matter. Understood?" You nod hastily. The tension dissipates and Hayden picks his plate back up. "Just make your way down to the Tack Shop, it's south of the Appliance Store. Talk to the sales associate there." You nod, still trying to process what you just learned. You couldn't make yourself believe that there was actually a unicorn in the forest, but you couldn't resist looking. "Oh- Wade. You'll need this." Hayden hands you a 200CP, and returns to his meal.

>talk to hayden
You look at Hayden, but he ignores you and your abscence of Curry Chicken Salad.

>s
Marketplace
You are in the center of the Marketplace. Look around to see where you want to go. If you get lost, head over to the General Store for a map.

>s
Appliance Store
The Appliance Store is small and rarely has anything in stock. You can look for an item, but it's probalby not in stock. As you enter the store, a cardboard cutout of Steve Jobs greets you.

* * *

>s
You didn't know the Tack Shop existed until today. You hadn't really ever had the need for horse-stuff. But perhaps there was something useful here. You see a sales associate.

>talk to associate
"Umm, hey," you say, walking up to the sales associate. She looks up at you.

"Can I help you with something?" She says curtly.

"Yes, actually. I'm looking to buy a saddle and a bridle."

"Yeah, how specific."

"Pardon?"

"Nothing. Here, let me just go grab some." She marches off in a huff, leaving you standing next to horse mannequins and a mini-fridge of carrots.

She returns with a simple black leather bridal over her shoulder and a saddle on her hip. "This work for you, kid?"

"Yeah, I suppose." She rings them up. "I'm going to give you these carrots for free, too. That'll be 200CP."

"Oh, okay." She hands the items to you and you struggle to hold them all. She snorts a laugh, and walks to the other side of the room.

>i
You are carrying:
  Bridle
  Saddle
  Carrots
  Four Coin Piece
  Nine Coin Piece
  Town Map
  Three Coin Piece
  Two And A Half Coin Piece
  Two-Coin Piece
  One And A Half Coin Piece
  One Coin Piece
  Simple Key
  Used Forks
  Sandwich Bag
  Wallet (closed)

>n
Appliance Store
The Appliance Store is small and rarely has anything in stock. You can look for an item, but it's probalby not in stock. As you enter the store, a cardboard cutout of Steve Jobs greets you.

>n
Marketplace
You are in the center of the Marketplace. Look around to see where you want to go. If you get lost, head over to the General Store for a map.

>ne.ne.
Park
A lovely little park. It has a few tall trees and a picnic bench. It looks like someone abandoned their picnic here.

You have no idea where the unicorn could be, and the trails are all a maze. You better start looking.

Forest
The forest is criss-crossed with hiking and biking trails. It's a nice place to go for a walk.

>n
Main Trail
You step onto the main trail. To the west, is the first trail. To the north, the main trail continues on.

>n
Main Trail
You continue along the main trail, and see the second trail to the east.

>n
Main Trail
You continue along the main trail. Two trails turn off: one to the east and one to the west. The main trail continues north.

>n
Main Trail
You continue along the main trail. The fifth trail turns off to the west.

>w
Fifth Trail
You turn west off of the main trail onto the fifth trail.

>take me to amara
Fifth Trail
You turn west and stumble into a clearing. There's a small pond and nibbling at the grass around it is a glistening silver unicorn. You move towards the unicorn. She spies you, and whips her head up in alert. You halt instantly, not wanting to scare her away. "Hey, pretty girl," you say, and reach for a carrot. She watches you intently. You hold the carrot out. "Hey girl, do you want a treat?" She paws at the ground. You take another step forward. Then another. And another. Finally, your outstretched arm holding the carrot is just infront of her head. She reaches forward, and takes the carrot. You give her another.

You can see Unicorn here.

>put bridle on unicorn
You stroke the unicorn's neck, then slip the bridle over her head. She protests a little, but gives in quickly. She doesn't seem to mind much, as if this is nothing new.

>put saddle on unicorn
You offer the unicorn another carrot, and while she is chewing you throw the saddle over her back. She doesn't seem to mind, as if this is nothing new. Her muzzle pushes into your pocket, looking for more carrots.

>ride unicorn
You step forward, and mount the unicorn.
"Hey, beautiful. Wow. I can't believe this is real."

"Hayden said you were coming," says a bell-like voice in your head. You nearly fall off the unicorn. "You're so silly," the voice continues. "My name is Amara." You look down at your mount.

"Are you the unicorn?" The bell-like voice chimes a laugh in your head.

"Yea, I am. So, I hear that we have somewhere special to go!"
Amara picks up a trot, and heads north. At about fifty yards away from the trees she hastens her pace, and leaps into the air. You clutch desperately at her soft white mane in an effort to stay on.

You look behind you as she climbs ever higher. You can see the town. A man in a black coat stands in the center of the marketplace, and seems to be watching you. But a blink later and he's gone. "Where are we going, Amara?"

"Oh, you'll see."

Broken Lighthouse
A cliff drops off towards the ocean, with a tall lighthouse looming over. The ocean is dark blue and frothy from slamming against the sharp rocks at the base of the cliff. To the north is an old, unkept cobblestone path.

(getting out of Broken Lighthouse)
But you aren't in anything at the moment.

>i
You are carrying:
  Unicorn Hair
  Carrots
  Four Coin Piece
  Nine Coin Piece
  Town Map
  Three Coin Piece
  Two And A Half Coin Piece
  Two-Coin Piece
  One And A Half Coin Piece
  One Coin Piece
  Simple Key
  Used Forks
  Sandwich Bag
  Wallet (closed)

* * *

>gonear mer-castle gate
Mer Castle Gate
The gate to Mer Castle is merely for show, as any creature could swim over the walls. Two guards draped in armor and holding spears are blocking the gate.

You can see Guard here.

>purloin wand
[Purloined.]

>purloin spellbook
Which do you mean, Spellbooks or Advanced Spellbook?

* * *

>gonear wand-shop
Wand Shop
The best kept store in town. The inside looks like a library, except instead of books stacked to the ceiling there are long slender boxes. Along the door are buckets of spellbooks.

You can see Wizard here.

>ak spellbook
That's not a verb I recognise.

>take spellbook
You reach forward and take a book. The wizard is still nowhere to be seen.

>gonear mer-castle gate
Mer Castle Gate
The gate to Mer Castle is merely for show, as any creature could swim over the walls. Two guards draped in armor and holding spears are blocking the gate.

You can see Guard here.

>x spellbook
Light: "Levis wand"
Extinguish Light: "Haud Levis Wand"
Attack: "Invado"
Put to Sleep: "Somnus"
Unlock: "resero"

>haud levis wand
You flick the wand, and the tip dims until there is no more light.

>invado guard
You throw an attack spell at the guard, but it only bounces off. He seems a little upset now, too. Smooth.

>talk to guard
You are slightly intimidated by the guards, but you need their help. "Hi," you say to one of the guards. "I'm from a far away land and I'm looking for a portal that will take me home. I need to speak to your king to see if he can, um, help me out with that." The guards ignore you.

>talk to guard
You continue to try to get the guards" attention, but they ignore you. You've almost given up when a beautiful merwoman swims up the street towards you. She is wearing a gold tiara and the guards come to attention when she approaches.

>talk to merwoman
"Who are you?" The mermaid snaps.
"Hi, I'm Wade." No response. "I'm from far away, from lands where there is no magic. Her composure instantly softens and she becomes very curious. 
"No magic? I've heard rumors, heard stories, but I never though.. could never believe.. why are you here?"
"I'm tryin to find my way home. I was told there is a portal that will send me back." The mermaid searches your face, as if trying to figure out if you are lying or not. 
"You must come with me," she says, and swims toward the castle gate which opens before her. Follow the mermaid?

>y
You kick your legs and swim after her into Mer Castle.

Mer Castle
The castle is gorgeous. The walls reach high and the light orbs float through the water and hang from the ceiling. The floors are made of smooth sandstone and an elegant staircase spirals up to the next floor. There are several doors along either side of you.

* * *

I beg your pardon?

>n
You can't go that way.

* * *

>gonear mer-castle gate
Mer Castle Gate
The gate to Mer Castle is merely for show, as any creature could swim over the walls. Two guards draped in armor and holding spears are blocking the gate.

You can see Guard here.

>talk to guard
You are slightly intimidated by the guards, but you need their help. "Hi," you say to one of the guards. "I'm from a far away land and I'm looking for a portal that will take me home. I need to speak to your king to see if he can, um, help me out with that." The guards ignore you.

* * *

>talk to guard
You continue to try to get the guards" attention, but they ignore you. You've almost given up when a beautiful merwoman swims up the street towards you. She is wearing a gold tiara and the guards come to attention when she approaches.

>talk to mermaid
"Who are you?" The mermaid snaps.
"Hi, I'm Wade." No response. "I'm from far away, from lands where there is no magic." Her composure instantly softens and she becomes very curious. 
"No magic? I've heard rumors, heard stories, but I never thought.. could never believe.. why are you here?"
"I'm trying to find my way home. I was told there is a portal that will send me back." The mermaid searches your face, as if trying to figure out if you are lying or not. 
"You must come with me," she says, and swims toward the castle gate which opens before her. Follow the mermaid?

>y
You kick your legs and swim after her into Mer Castle.

Mer Castle
The castle is gorgeous. The walls reach high and the light orbs float through the water and hang from the ceiling. The floors are made of smooth sandstone and an elegant staircase spirals up to the next floor. There are several doors along either side of you.

"I'm just so interested in your story," she says. "You're just like the other land people. How are you down here? How can you breathe water if you're non-magic?"
"I drank a potion. But I'm not here to talk, I'm sorry. I need to find the portal to get home." The mermaid grabs a hold of your arm. 
"Don't leave, landman. Stay here, with me, and tell me of your world. You will be famous, you can write stories, stay here."
Forget your portal search and stay with her?

>n
"I'm sorry," you say. "I have to go home; I cannot stay here." The mermaid is obviously conflicted.
"I'm the princess here," she says. "I can promise you this fortune." Are you sure you don't want her promised fortune?

>y
"I'm sorry, I have to decline. Is your father, or someone else who might be able to help me available?" Pouting slightly, the princess swims off. She returns quickly with a dignified merman draped in gold jewelry and a crown.

>talk to merman
"Your highness," you say, trying your best to bow in the water.
"Human. Stop flailing. What ever could you want so desperately as to draw me to listen to your simple, unimportant desires." His voice booms through the water and you consider turning around and leaving.
"Hayden sent me," you say cautiously, hoping it will mean something to him. Apparently it does, as he roars in laughter.
"Hayden? The simpleton? Ahaha! What a simple joke!" 
"Or, Hayden just let me know of this place. The blacksmith sent me in this direction," you say hurridly, trying to fix your mistake.
"There are many blacksmiths, fool. The closest landman who calls himself a blacksmith is just a fool simpleton like your friend Hayden. You are wasting my time, landman."
"No- wait. Please. I'm not from here. I'm from the non-magic world." This caught his attention. "My name is Wade, sir. Hayden sent me here to find something but I have no idea what. I'm just trying to find the portal back to my world."
"There is no portal here!"
"As unfortunate as that is, I'm not surprised. I just wanted to know if you knew anything about the portal, if you could send me on the right track, give me a clue, anything…"

The Mer King studies you quietly for a few minutes. "There is a gate on the path that you must take. It is locked. I have the key."
"Oh, that's great!" You are very excited. 
"But I want something of you before I give it. There is a giant ogre who lives in Stone Valley Pass. He often comes to the lake and "frolics" in the water. His weight and stomping destroys the tunnel and our men have to work hard to fix it before we run out of oxygen. He polutes the water and diseases the fish. Bring me proof that you have slain this evil beast, and I shall give you your key."
The Mer King refuses to talk to you until you bring him proof that you have slain the ogre.

>talk to mer king
The Mer King refuses to talk to you until you bring him proof that you have slain the ogre.

>s
Mer Castle Gate
The gate to Mer Castle is merely for show, as any creature could swim over the walls. Two guards draped in armor and holding spears are blocking the gate.

You can see Guard here.

>n
Mer Castle
The castle is gorgeous. The walls reach high and the light orbs float through the water and hang from the ceiling. The floors are made of smooth sandstone and an elegant staircase spirals up to the next floor. There are several doors along either side of you.

You can see Mer King here.

>s
Mer Castle Gate
The gate to Mer Castle is merely for show, as any creature could swim over the walls. Two guards draped in armor and holding spears are blocking the gate.

You can see Guard here.

>s
You enter a city and are speachless. Mermaids are swimming around carelessly and small homes are settled on the floor of the lake, completely sumberged in a giant underwater cave. Glowing orbs line the streets, fill the homes, and adorn the cave walls, bringing a bright but artificial light to the city. A beautiful sandstone castle lays due north.

Mer City
Mer City is beautiful. Mermen and merwomen swim around town as normal as if they were people on land. Each home has a small garden of kelp. The castle gate is north, and the castle lays just behind it.

>s
You swim down into a tunnel, following it until it spits you out into an underwater world.

>u
You can't go that way.

>i
You are carrying nothing.

>u
You can't go that way.

>n
Mer Castle Gate
The gate to Mer Castle is merely for show, as any creature could swim over the walls. Two guards draped in armor and holding spears are blocking the gate.

You can see Guard here.

>u
You can't go that way.

>s
Mer City
Mer City is beautiful. Mermen and merwomen swim around town as normal as if they were people on land. Each home has a small garden of kelp. The castle gate is north, and the castle lays just behind it.

>u
You can't go that way.

>u
You can't go that way.

>s
You swim down into a tunnel, following it until it spits you out into an underwater world.

>e
You can't go that way.

>n
Mer Castle Gate
The gate to Mer Castle is merely for show, as any creature could swim over the walls. Two guards draped in armor and holding spears are blocking the gate.

You can see Guard here.

>s
Mer City
Mer City is beautiful. Mermen and merwomen swim around town as normal as if they were people on land. Each home has a small garden of kelp. The castle gate is north, and the castle lays just behind it.

* * *

>u
You can't go that way.

>l
Mer City
Mer City is beautiful. Mermen and merwomen swim around town as normal as if they were people on land. Each home has a small garden of kelp. The castle gate is north, and the castle lays just behind it.

>u
You can't go that way.

>swim up
That's not a verb I recognise.

>go up
You can't go that way.

>purloin breathing-potion
Which do you mean, Breathing Potion or Breathing?

>breathing potion
[Purloined.]

>drink potion
You can't see any such thing.

>drink breathing potion
"Here goes nothing," you say, and tip the potion into your mouth. It tastes like a mix of raw octopus and chalk.

>n
Mer Castle Gate
The gate to Mer Castle is merely for show, as any creature could swim over the walls. Two guards draped in armor and holding spears are blocking the gate.

You can see Guard here.

* * *

>s
You swim down into a tunnel, following it until it spits you out into an underwater world.

>talk to witch
You can't see any such thing.

>sw
You can't go that way.

>gonear lake
Lake
A beautiful lake stretches before you, but the path seems to end at its bank.

>sw
Northeast Path
The lake is to the northeast while the path retreats to the southwest.

>go southwest
Dirt Path
The end of the dirt path forks northeast and northwest.

>gonear lake
Lake
A beautiful lake stretches before you, but the path seems to end at its bank.

* * *

>sw
Northeast Path
The lake is to the northeast while the path retreats to the southwest.

>w
You can't go that way.

>sw
Dirt Path
The end of the dirt path forks northeast and northwest.

>s
You approach the ogre, quietly.

Natural light creeps into the valley as you step back out onto the dirt path.

Stone Valley Pass

>i
You are carrying nothing.

>purloin wand
[Purloined.]

* * *

>purloin spellbook
Which do you mean, Spellbooks or Advanced Spellbook?

>spellbook
Which do you mean, Spellbooks or Advanced Spellbook?

>gonear wand-shop
Wand Shop
The best kept store in town. The inside looks like a library, except instead of books stacked to the ceiling there are long slender boxes. Along the door are buckets of spellbooks.

You can see Wizard here.

* * *

>take spellbook
You reach forward and take a book. The wizard is still nowhere to be seen.

>gonear northeast path
Northeast Path
The lake is to the northeast while the path retreats to the southwest.

>sw
Dirt Path
The end of the dirt path forks northeast and northwest.

>s
You approach the ogre, quietly.

Stone Valley Pass

>purloin sword
[Purloined.]

>purloin blunt weapon
[Purloined.]

>purloin spear
[Purloined.]

>purloin axe
[Purloined.]

>purloin shield
[Purloined.]

>attack ogre
You can't see any such thing.

>l
Stone Valley Pass

>s
Stone Valley Pass
You continue along the path. Up ahead looms the silhouette of a giant beast. The stench of rotting flesh and bad hygene assaults your nose..

You can see Ogre here.

>slay ogre
What do you want to slay Ogre with?

>slay ogre with sword
You lash out with the sword, but you can't reach his neck.

>i
You are carrying:
  Shield
  Axe
  Spear
  Blunt Weapon
  Sword
  Spellbook
  Wand

>slay ogre with axe
You throw the axe at the ogre, but it just bounces off. Now you've lost your axe.

I beg your pardon?

>attack ogre with axe
You can't see any such thing.

I beg your pardon?

>i
You are carrying:
  Shield
  Spear
  Blunt Weapon
  Sword
  Spellbook
  Wand

>attack ogre with blunt weapon
You club at the knees of the giant ogre, avoiding his return blows. His legs give out, and he falls towards the ground. He continues to flail at you, roaring in hatrid and anguish.

>slay ogre with sword
You step breavey up to the fallen ogre, brandishing your sword over your head. With all of your strength you bring the sword down on the ogre. He falls to the ground.

>l
Stone Valley Pass
You continue along the path. The corpse of the dead ogre fills up most of that path.

You can see a dead ogre here.

>x dead ogre
The body of the ogre. He is wearing a tunic, but nothing else.

>take tunic
You bend over and take the shreds of burlap, gaging at its putrid smell.

>i
You are carrying:
  Ogre Tunic
  Shield
  Spear
  Blunt Weapon
  Sword
  Spellbook
  Wand

>n
Stone Valley Pass

>n
Dirt Path
The end of the dirt path forks northeast and northwest.

>ne
Northeast Path
The lake is to the northeast while the path retreats to the southwest.

>ne
Lake
A beautiful lake stretches before you, but the path seems to end at its bank.

>talk to wtich
You can't see any such thing.

>talk to witch
You can't see any such thing.

>l
Lake
A beautiful lake stretches before you, but the path seems to end at its bank.

* * *

>slay ogre with sword
You can't see any such thing.

>take tunic
You bend over and take the shreds of burlap, gaging at its putrid smell.

>n
lake water
The lake water is dark.  According to the witch, the path continues at the center of the lake, straight down.

>n
You can't go that way.

>ne
You can't go that way.

>ne
You can't go that way.

>talk to witch
You can't see any such thing.

>n
You can't go that way.

>d
You swim down into a tunnel, following it until it spits you out into an underwater world.

>n
You can't go that way.

>n
You can't go that way.

>attack guard
You can't see any such thing.

>slay guard with sword
You can't see any such thing.

>i
You are carrying:
  Ogre Tunic
  Shield
  Spear
  Blunt Weapon
  Sword
  Spellbook
  Wand

>n
You can't go that way.

>talk to mermaid princess
You can't see any such thing.

I beg your pardon?

>talk to mer king
You can't see any such thing.

>talk to mer king
You can't see any such thing.

>talk to princess
You can't see any such thing.

I beg your pardon?

>s
Lake
A beautiful lake stretches before you, but the path seems to end at its bank.

>s
You can't go that way.

>u
You can't go that way.

>i
You are carrying:
  Ogre Tunic
  Shield
  Spear
  Blunt Weapon
  Sword
  Spellbook
  Wand

* * *

>talk to guard
You continue to try to get the guards" attention, but they ignore you. You've almost given up when a beautiful merwoman swims up the street towards you. She is wearing a gold tiara and the guards come to attention when she approaches.

>talk to princess
"Who are you?" The mermaid snaps.
"Hi, I'm Wade." No response. "I'm from far away, from lands where there is no magic." Her composure instantly softens and she becomes very curious. 
"No magic? I've heard rumors, heard stories, but I never thought.. could never believe.. why are you here?"
"I'm trying to find my way home. I was told there is a portal that will send me back." The mermaid searches your face, as if trying to figure out if you are lying or not. 
"You must come with me," she says, and swims toward the castle gate which opens before her. Follow the mermaid?

>y
You kick your legs and swim after her into Mer Castle.

Mer Castle
The castle is gorgeous. The walls reach high and the light orbs float through the water and hang from the ceiling. The floors are made of smooth sandstone and an elegant staircase spirals up to the next floor. There are several doors along either side of you.

"I'm just so interested in your story," she says. "You're just like the other land people. How are you down here? How can you breathe water if you're non-magic?"
"I drank a potion. But I'm not here to talk, I'm sorry. I need to find the portal to get home." The mermaid grabs a hold of your arm. 
"Don't leave, landman. Stay here, with me, and tell me of your world. You will be famous, you can write stories, stay here."
Forget your portal search and stay with her?

* * *

>purloin ogre tunic
[Purloined.]

>talk to mer king
The king, full of joy, welcomes you back. "You have done it, landman! Here, as promised." He hands you the gate key.
The Mer King is busy. He cannot speak to you now.

>i
You are carrying:
  Gate Key

>s
Mer Castle Gate
The gate to Mer Castle is merely for show, as any creature could swim over the walls. Two guards draped in armor and holding spears are blocking the gate.

You can see Guard here.

* * *

>s
You enter a city and are speachless. Mermaids are swimming around carelessly and small homes are settled on the floor of the lake, completely sumberged in a giant underwater cave. Glowing orbs line the streets, fill the homes, and adorn the cave walls, bringing a bright but artificial light to the city. A beautiful sandstone castle lays due north.

Mer City
Mer City is beautiful. Mermen and merwomen swim around town as normal as if they were people on land. Each home has a small garden of kelp. The castle gate is north, and the castle lays just behind it.

>s
"Wait!" Calls the mermaid princess, swimming after you. "I hope you won't forget my offer," she begins.
"Don't worry, I won't."
"Here, you earned this." She passes you a book. "I see you're carrying a wand, but that's useless without knowing any real spells." 
You thank her, and then continue on your way.

Tunnel
The tunnel continues north. To go back to the lake, just swim up.

>u
You tread into the water, but you know you can't hold your breath for long so you return to the shore. Perhaps that potion will work.

>purloing breathing-potion
That's not a verb I recognise.

>purloin breathing-potion
Which do you mean, Breathing Potion or Breathing?

* * *

>breathing potion
[Purloined.]

>drink breathing potion
"Here goes nothing," you say, and tip the potion into your mouth. It tastes like a mix of raw octopus and chalk.

>n
Mer City
Mer City is beautiful. Mermen and merwomen swim around town as normal as if they were people on land. Each home has a small garden of kelp. The castle gate is north, and the castle lays just behind it.

>s
"Wait!" Calls the mermaid princess, swimming after you. "I hope you won't forget my offer," she begins.
"Don't worry, I won't."
"Here, you earned this." She passes you a book. "I see you're carrying a wand, but that's useless without knowing any real spells." 
You thank her, and then continue on your way.

Tunnel
The tunnel continues north. To go back to the lake, just swim up.

>u
lake water
The lake water is dark.  According to the witch, the path continues at the center of the lake, straight down.

>s
Lake
A beautiful lake stretches before you, but the path seems to end at its bank.

You can see Witch here.

>talk to witch
"Go away, boy. I have things to do."

>sw
Northeast Path
The lake is to the northeast while the path retreats to the southwest.

>nw
You can't go that way.

>sw
Dirt Path
The end of the dirt path forks northeast and northwest.

>nw
You turn left onto the path and continue until you come upon a giant Sphinx. She blocks your path. Her tail twitches.

Northwest Path
A continuation of the trail. The path continues northwest while it returns southeast.

You can see Sphinx here.

* * *

>talk to sphinx
"Um, hello?" The sphinx looks at you emotionlessly.
"I have riddles of three," she says. "Answer them all, and ye shall be free." 
"Well, okay-"
"But, fail simply one, and ye shall be none." Attempt her riddles?

>y
(answer questions: "answer …s:")

"Give me food, and I live. Give me drink, and I die. What am I?"

* * *

>answer fire
(to Sphinx)
The sphinx looks at you. "Yes." She says simply.

>talk to sphinx
"What force and strength cannot get through,
I with a simple action can do.
Many a man would stand,
barred from their abode,
were I not held in their hand."

>answer mirror
(to Sphinx)
"Yes." She says. She stands up, ruffles her wings, and walks to the side of the path, allowing you to pass through.

>nw
"You may not pass." Booms the Sphinx. "Two more riddles."

>talk to sphinx
"What force and strength cannot get through,
I with a simple action can do.
Many a man would stand,
barred from their abode,
were I not held in their hand."

* * *

>answer key
(to Sphinx)
The sphinx remains motionless. "Yes."

>nw
Northwest Path
You continue along the path. The sphinx is to the southeast. The trail continues north.

>n
As you climb higher up the path the trees around you start to thicken. To the north you see the mouth of a large cave.

Cave
The cave mouth is rather large. It continues north, while the path is south.

>n
You continue into the darkness of the cave, and come upon a giant, floor-to-ceiling steel gate. This must be what the Mer King was talking about.

>w
(first opening Steel Gate)
You rattle the cold bars, but the gate is locked.

>unlock gate
(Gate Key with Gate Key)
That doesn't seem to be something you can unlock.

>unlock steel gate with gate key
You unlock Steel Gate.

>open gate
(Gate Key)
That's not something you can open.

>w
(first opening Steel Gate)
With a heave you push the heavy gate open. Flakes of rust fall down around you.

Empty Room
The gate opens up to a large, empty room. The walls are lined with flickering blue fire torches. To the north the shadow of a spiral staircase winds it's way into the darkness with only the flickering of the magic fire to light the steps. Each footfall echoes.

You can see Spiral Staircase and Steel Gate here.

>x torches
Simple torches fixed to the walls by what must be magic. A ball of blue flames flickers slowly atop each torch.

>n
You advance towards the staircase, daunted by the hundreds of steps.

Portal Chamber
A medium sized room lit by rows of blue fire torches and a large purple portal to the north. A large gold cauldron sits ontop of a green flame in the center of the room. A tall wizard is burrowing his nose into an old leather bound book, muttering an ancient language to himself.

You can see Spiral Staircase and Grand Wizard here.

>purloin wand
[Purloined.]

>purloin wand
[Purloined.]

>i
You are carrying:
  Wand
  Gate Key

>purloin advanced spellbook
[Purloined.]

>l
Portal Chamber
A medium sized room lit by rows of blue fire torches and a large purple portal to the north. A large gold cauldron sits ontop of a green flame in the center of the room. A tall wizard is burrowing his nose into an old leather bound book, muttering an ancient language to himself.

You can see Spiral Staircase and Grand Wizard here.

>x cauldron
You can't see any such thing.

>x green flame
You can't see any such thing.

>x wizard
A tall and dangeriously skinny wizard with a bad slouch and a brilliant blue robe. His wand is long and full of knotts.

>n
You approach the portal, determined to leave this confusing world. But the wizard blocks your path.

>attack wizard
Violence isn't the answer to this one.

>talk to wizard
"What! Who are you?!" The wizard demands furiously.
"Hi. I'm-" The wizard doesn't seem to care.
 "Obstupefio!" He cries defiantly, his wand pointed straight at you. You feel your body grow stiff, and you fall backwards against the wall. You are temporarily paralyzed.
 The wizard returns to his potion and becomes visibly distressed, looking between his cauldron and his book, muttering under his breath. He turns slowly to look at you. "Concalo pars" he says with a flick of his wand. Every potion related item that you're carrying flies towards him.

>talk to wizard
"What! Who are you?!" The wizard demands furiously.
"Hi. I'm-" The wizard doesn't seem to care.
 "Obstupefio!" He cries defiantly, his wand pointed straight at you. You feel your body grow stiff, and you fall backwards against the wall. You are temporarily paralyzed.
 The wizard returns to his potion and becomes visibly distressed, looking between his cauldron and his book, muttering under his breath. He turns slowly to look at you. "Concalo pars" he says with a flick of his wand. Every potion related item that you're carrying flies towards him.

>x spellbook
Light: "levis wand"
Extinguish Light: "haud levis wand"
Sleep: "somnus"
Attack: "invado"
Disarm: "detrahere arma"
Disorient: "conturbatus"
Temporarily Paralyze: "obstupefio"
Block: "oppilo"
Push Aside: "trudo"
Render Immobile: "inerrans"
Throw Fire: "accendo"

>somnus
What do you want to somnus?

>somnus wizard
Why would you put that to sleep?

>zomnus disarm
That's not a verb I recognise.

>obstupefio
(Grand Wizard)
You try to paralyze the Grand wizard, but he easily deflects it. He cries"Accendo!" A stream of fire bubbles hutle themselves at you, burning your clothes and leaving black stains on the rock around you.

>accendo
(Grand Wizard)
He easily deflects your fireballs, sending them down the staircase from which you came. He cries "Inerrans!" You are frozen in place temporarily while the wizard continues working on his potion.

>inerrans
(Grand Wizard)
The wizard laughs at your incompitence. He cries"Accendo!" A stream of fire bubbles hutle themselves at you, burning your clothes and leaving black stains on the rock around you.

>obstupefio
(Grand Wizard)
You remporarily paralyze the wizard, and are able to throw another spell in.

>invado
What do you want to invado?

>invado wizard
Why would you attack Grand Wizard?

>oppilo
(Grand Wizard)
You try to deflect his attack, but you miss. He cries"Obstupefio!" Once again, you are temporarily paralyzed.

>x spellbook
Light: "levis wand"
Extinguish Light: "haud levis wand"
Sleep: "somnus"
Attack: "invado"
Disarm: "detrahere arma"
Disorient: "conturbatus"
Temporarily Paralyze: "obstupefio"
Block: "oppilo"
Push Aside: "trudo"
Render Immobile: "inerrans"
Throw Fire: "accendo"

>detrahere arma
(Grand Wizard)
You try to disarm the wizard, but he easily deflects it. He cries"Accendo!" A stream of fire bubbles hutle themselves at you, burning your clothes and leaving black stains on the rock around you.

>conturbatus
(Grand Wizard)
With a flick of your wand you cause the Grand Wizard to become disoriented. He stumbles around, trying to figure out where he is.

>detrahera arma
That's not a verb I recognise.

>detrahere arma
(Grand Wizard)
You try to disarm the wizard, but he easily deflects it. He cries"Trudo!" You are forced by an invisible hand to the side with such force that you fall over.

>oppilo
(Grand Wizard)
You try to deflect his attack, but you miss. He cries "Detrahere Arma"! Your wand is thrown out of your hands and you scramble to reclaim it.

>accendo
(Grand Wizard)
He easily deflects your fireballs, sending them down the staircase from which you came. He cries "Conturbatus!" You're instantly confused, stumbling around trying to figure out where you are.

>x spellbook
Light: "levis wand"
Extinguish Light: "haud levis wand"
Sleep: "somnus"
Attack: "invado"
Disarm: "detrahere arma"
Disorient: "conturbatus"
Temporarily Paralyze: "obstupefio"
Block: "oppilo"
Push Aside: "trudo"
Render Immobile: "inerrans"
Throw Fire: "accendo"

>detrahere arma
(Grand Wizard)
You try to disarm the wizard, but he easily deflects it. He cries"Obstupefio!" Once again, you are temporarily paralyzed.

>x wizard
A tall and dangeriously skinny wizard with a bad slouch and a brilliant blue robe. His wand is long and full of knotts.

>conturbatus
(Grand Wizard)
You throw a jinx at the wizard, but he easily deflects it. He cries "Conturbatus!" You're instantly confused, stumbling around trying to figure out where you are.

>conturbatus
(Grand Wizard)
You throw a jinx at the wizard, but he easily deflects it. He cries "Detrahere Arma"! Your wand is thrown out of your hands and you scramble to reclaim it.

>obstupefio
(Grand Wizard)
You remporarily paralyze the wizard, and are able to throw another spell in.

>obstupefio
(Grand Wizard)
You remporarily paralyze the wizard, and are able to throw another spell in.

I beg your pardon?

>obstupefio
(Grand Wizard)
You try to paralyze the Grand wizard, but he easily deflects it. He cries "Inerrans!" You are frozen in place temporarily while the wizard continues working on his potion.

>x spellbook
Light: "levis wand"
Extinguish Light: "haud levis wand"
Sleep: "somnus"
Attack: "invado"
Disarm: "detrahere arma"
Disorient: "conturbatus"
Temporarily Paralyze: "obstupefio"
Block: "oppilo"
Push Aside: "trudo"
Render Immobile: "inerrans"
Throw Fire: "accendo"

>oppilo
(Grand Wizard)
You try to deflect his attack, but you miss. He cries"Accendo!" A stream of fire bubbles hutle themselves at you, burning your clothes and leaving black stains on the rock around you.

>trudo
(Grand Wizard)
The wizard is shoved to the side by your spell.

>n
You approach the portal, determined to leave this confusing world. But the wizard blocks your path.

>x spellbook
Light: "levis wand"
Extinguish Light: "haud levis wand"
Sleep: "somnus"
Attack: "invado"
Disarm: "detrahere arma"
Disorient: "conturbatus"
Temporarily Paralyze: "obstupefio"
Block: "oppilo"
Push Aside: "trudo"
Render Immobile: "inerrans"
Throw Fire: "accendo"

>detrahere arma
(Grand Wizard)
You try to disarm the wizard, but he easily deflects it. He cries "Inerrans!" You are frozen in place temporarily while the wizard continues working on his potion.

>detrahere arma
(Grand Wizard)
You try to disarm the wizard, but he easily deflects it. He cries"Trudo!" You are forced by an invisible hand to the side with such force that you fall over.

>detrahere arma
(Grand Wizard)
You try to disarm the wizard, but he easily deflects it. He cries"Accendo!" A stream of fire bubbles hutle themselves at you, burning your clothes and leaving black stains on the rock around you.

>contrubatus
That's not a verb I recognise.

>conturbatus
(Grand Wizard)
You throw a jinx at the wizard, but he easily deflects it. He cries "Conturbatus!" You're instantly confused, stumbling around trying to figure out where you are.

>conturbatus
(Grand Wizard)
With a flick of your wand you cause the Grand Wizard to become disoriented. He stumbles around, trying to figure out where he is.

>conturbatus
(Grand Wizard)
You throw a jinx at the wizard, but he easily deflects it. He cries "Detrahere Arma"! Your wand is thrown out of your hands and you scramble to reclaim it.

>conturbatus
(Grand Wizard)
With a flick of your wand you cause the Grand Wizard to become disoriented. He stumbles around, trying to figure out where he is.

>x spellbook
Light: "levis wand"
Extinguish Light: "haud levis wand"
Sleep: "somnus"
Attack: "invado"
Disarm: "detrahere arma"
Disorient: "conturbatus"
Temporarily Paralyze: "obstupefio"
Block: "oppilo"
Push Aside: "trudo"
Render Immobile: "inerrans"
Throw Fire: "accendo"

>obstupefio
(Grand Wizard)
You try to paralyze the Grand wizard, but he easily deflects it. He cries"Accendo!" A stream of fire bubbles hutle themselves at you, burning your clothes and leaving black stains on the rock around you.

>obstupefio
(Grand Wizard)
You try to paralyze the Grand wizard, but he easily deflects it. He cries "Inerrans!" You are frozen in place temporarily while the wizard continues working on his potion.

>obstupefio
(Grand Wizard)
You try to paralyze the Grand wizard, but he easily deflects it. He cries "Detrahere Arma"! Your wand is thrown out of your hands and you scramble to reclaim it.

>oppilo
(Grand Wizard)
You try to deflect his attack, but you miss. He cries"Trudo!" You are forced by an invisible hand to the side with such force that you fall over.

>oppilo
(Grand Wizard)
You try to deflect his attack, but you miss. He cries "Detrahere Arma"! Your wand is thrown out of your hands and you scramble to reclaim it.

>oppilo
(Grand Wizard)
You try to deflect his attack, but you miss. He cries"Accendo!" A stream of fire bubbles hutle themselves at you, burning your clothes and leaving black stains on the rock around you.

>oppilo
(Grand Wizard)
You successfuly manage to block his spell.

>oppilo
(Grand Wizard)
You try to deflect his attack, but you miss. He cries "Inerrans!" You are frozen in place temporarily while the wizard continues working on his potion.

>x spellbook
Light: "levis wand"
Extinguish Light: "haud levis wand"
Sleep: "somnus"
Attack: "invado"
Disarm: "detrahere arma"
Disorient: "conturbatus"
Temporarily Paralyze: "obstupefio"
Block: "oppilo"
Push Aside: "trudo"
Render Immobile: "inerrans"
Throw Fire: "accendo"

>trudo
(Grand Wizard)
The wizard easily blocks your attack. He cries"Obstupefio!" Once again, you are temporarily paralyzed.

>trudo
(Grand Wizard)
The wizard easily blocks your attack. He cries"Trudo!" You are forced by an invisible hand to the side with such force that you fall over.

>trudo
(Grand Wizard)
The wizard easily blocks your attack. He cries "Detrahere Arma"! Your wand is thrown out of your hands and you scramble to reclaim it.

>inerrans
(Grand Wizard)
The wizard laughs at your incompitence. He cries"Obstupefio!" Once again, you are temporarily paralyzed.

>accendo
(Grand Wizard)
He easily deflects your fireballs, sending them down the staircase from which you came. He cries"Accendo!" A stream of fire bubbles hutle themselves at you, burning your clothes and leaving black stains on the rock around you.

>accendo
(Grand Wizard)
He easily deflects your fireballs, sending them down the staircase from which you came. He cries"Trudo!" You are forced by an invisible hand to the side with such force that you fall over.

>accendo
(Grand Wizard)
He easily deflects your fireballs, sending them down the staircase from which you came. He cries "Inerrans!" You are frozen in place temporarily while the wizard continues working on his potion.

>accendo
(Grand Wizard)
Balls of fire shoot out from your wand, landing on and around the wizard. He screams and tries to put them out.

>x red stone
A gorgeous red stone. You've never seen a jewl as beautiful as this.

>take stone
You have to defeat the wizard before you can take that!

>i
You are carrying:
  Advanced Spellbook
  Wand
  Gate Key

>x red beryl
I only understood you as far as wanting to examine Red Stone.

>x spellbook
Light: "levis wand"
Extinguish Light: "haud levis wand"
Sleep: "somnus"
Attack: "invado"
Disarm: "detrahere arma"
Disorient: "conturbatus"
Temporarily Paralyze: "obstupefio"
Block: "oppilo"
Push Aside: "trudo"
Render Immobile: "inerrans"
Throw Fire: "accendo"

>detrahere arma
(Grand Wizard)
You try to disarm the wizard, but he easily deflects it. He cries"Trudo!" You are forced by an invisible hand to the side with such force that you fall over.

The wizard strikes you down, defeating you. Accept your defeat with death?

>detrahere arma
Please answer yes or no.

>n
You restart the challenge.

>x spellbook
Light: "levis wand"
Extinguish Light: "haud levis wand"
Sleep: "somnus"
Attack: "invado"
Disarm: "detrahere arma"
Disorient: "conturbatus"
Temporarily Paralyze: "obstupefio"
Block: "oppilo"
Push Aside: "trudo"
Render Immobile: "inerrans"
Throw Fire: "accendo"

>detrahere arma
(Grand Wizard)
You try to disarm the wizard, but he easily deflects it. He cries "Conturbatus!" You're instantly confused, stumbling around trying to figure out where you are.

>detrahere arma
(Grand Wizard)
You try to disarm the wizard, but he easily deflects it. He cries"Obstupefio!" Once again, you are temporarily paralyzed.

>detrahere arma
(Grand Wizard)
You try to disarm the wizard, but he easily deflects it. He cries "Inerrans!" You are frozen in place temporarily while the wizard continues working on his potion.

>detrahere arma
(Grand Wizard)
You try to disarm the wizard, but he easily deflects it. He cries "Detrahere Arma"! Your wand is thrown out of your hands and you scramble to reclaim it.

>detrahere arma
(Grand Wizard)
You try to disarm the wizard, but he easily deflects it. He cries"Trudo!" You are forced by an invisible hand to the side with such force that you fall over.

>detrahere arma
(Grand Wizard)
You try to disarm the wizard, but he easily deflects it. He cries "Inerrans!" You are frozen in place temporarily while the wizard continues working on his potion.

* * *

>detrahere arma
(Grand Wizard)
You try to disarm the wizard, but he easily deflects it. He cries"Trudo!" You are forced by an invisible hand to the side with such force that you fall over.

>detrahere arma
(Grand Wizard)
You try to disarm the wizard, but he easily deflects it. He cries "Conturbatus!" You're instantly confused, stumbling around trying to figure out where you are.

* * *

>detrahere arma
(Grand Wizard)
You try to disarm the wizard, but he easily deflects it. He cries"Obstupefio!" Once again, you are temporarily paralyzed.

>detrahere arma
(Grand Wizard)
You try to disarm the wizard, but he easily deflects it. He cries "Detrahere Arma"! Your wand is thrown out of your hands and you scramble to reclaim it.

>detrahere arma
(Grand Wizard)
You try to disarm the wizard, but he easily deflects it. He cries "Conturbatus!" You're instantly confused, stumbling around trying to figure out where you are.

>detrahere arma
(Grand Wizard)
You try to disarm the wizard, but he easily deflects it. He cries "Inerrans!" You are frozen in place temporarily while the wizard continues working on his potion.

* * *

>detrahere arma
(Grand Wizard)
You try to disarm the wizard, but he easily deflects it. He cries"Trudo!" You are forced by an invisible hand to the side with such force that you fall over.

>detrahere arma
(Grand Wizard)
You try to disarm the wizard, but he easily deflects it. He cries "Detrahere Arma"! Your wand is thrown out of your hands and you scramble to reclaim it.

>detrahere arma
(Grand Wizard)
You try to disarm the wizard, but he easily deflects it. He cries "Inerrans!" You are frozen in place temporarily while the wizard continues working on his potion.

* * *

>detrahere arma
(Grand Wizard)
You try to disarm the wizard, but he easily deflects it. He cries"Accendo!" A stream of fire bubbles hutle themselves at you, burning your clothes and leaving black stains on the rock around you.

>x spellbook
Light: "levis wand"
Extinguish Light: "haud levis wand"
Sleep: "somnus"
Attack: "invado"
Disarm: "detrahere arma"
Disorient: "conturbatus"
Temporarily Paralyze: "obstupefio"
Block: "oppilo"
Push Aside: "trudo"
Render Immobile: "inerrans"
Throw Fire: "accendo"

>conturbatus
(Grand Wizard)
With a flick of your wand you cause the Grand Wizard to become disoriented. He stumbles around, trying to figure out where he is.

>obstupefio
(Grand Wizard)
You try to paralyze the Grand wizard, but he easily deflects it. He cries"Trudo!" You are forced by an invisible hand to the side with such force that you fall over.

>obstupefio
(Grand Wizard)
You remporarily paralyze the wizard, and are able to throw another spell in.

>oppilo
(Grand Wizard)
You try to deflect his attack, but you miss. He cries"Trudo!" You are forced by an invisible hand to the side with such force that you fall over.

>oppilo
(Grand Wizard)
You try to deflect his attack, but you miss. He cries "Inerrans!" You are frozen in place temporarily while the wizard continues working on his potion.

>oppilo
(Grand Wizard)
You successfuly manage to block his spell.

>trudo
(Grand Wizard)
The wizard easily blocks your attack. He cries "Conturbatus!" You're instantly confused, stumbling around trying to figure out where you are.

>trudo
(Grand Wizard)
The wizard easily blocks your attack. He cries"Accendo!" A stream of fire bubbles hutle themselves at you, burning your clothes and leaving black stains on the rock around you.

>trudo
(Grand Wizard)
The wizard is shoved to the side by your spell.

>x spellbook
Light: "levis wand"
Extinguish Light: "haud levis wand"
Sleep: "somnus"
Attack: "invado"
Disarm: "detrahere arma"
Disorient: "conturbatus"
Temporarily Paralyze: "obstupefio"
Block: "oppilo"
Push Aside: "trudo"
Render Immobile: "inerrans"
Throw Fire: "accendo"

>inerrans
(Grand Wizard)
The wizard laughs at your incompitence. He cries "Inerrans!" You are frozen in place temporarily while the wizard continues working on his potion.

>inerrans
(Grand Wizard)
You render the wizard immobile, and are able to throw another spell at him.

>accendo
(Grand Wizard)
He easily deflects your fireballs, sending them down the staircase from which you came. He cries"Trudo!" You are forced by an invisible hand to the side with such force that you fall over.

>accendo
(Grand Wizard)
He easily deflects your fireballs, sending them down the staircase from which you came. He cries"Obstupefio!" Once again, you are temporarily paralyzed.

>accendo
(Grand Wizard)
He easily deflects your fireballs, sending them down the staircase from which you came. He cries "Conturbatus!" You're instantly confused, stumbling around trying to figure out where you are.

>accendo
(Grand Wizard)
He easily deflects your fireballs, sending them down the staircase from which you came. He cries"Obstupefio!" Once again, you are temporarily paralyzed.

>accendo
(Grand Wizard)
He easily deflects your fireballs, sending them down the staircase from which you came. He cries "Detrahere Arma"! Your wand is thrown out of your hands and you scramble to reclaim it.

>accendo
(Grand Wizard)
He easily deflects your fireballs, sending them down the staircase from which you came. He cries "Inerrans!" You are frozen in place temporarily while the wizard continues working on his potion.

>accendo
(Grand Wizard)
He easily deflects your fireballs, sending them down the staircase from which you came. He cries "Detrahere Arma"! Your wand is thrown out of your hands and you scramble to reclaim it.

>accendo
(Grand Wizard)
He easily deflects your fireballs, sending them down the staircase from which you came. He cries"Obstupefio!" Once again, you are temporarily paralyzed.

>accendo
(Grand Wizard)
He easily deflects your fireballs, sending them down the staircase from which you came. He cries"Trudo!" You are forced by an invisible hand to the side with such force that you fall over.

>accendo
(Grand Wizard)
Balls of fire shoot out from your wand, landing on and around the wizard. He screams and tries to put them out.

With your final spell you bring the wizard to his knees, defeated. "How did you…映物" he says, falling onto his hands.
"Obstupefio!" you cry, paralyzing him. The wizard falls to the ground, his eyes the only part of his body that moves. Around his neck is a thick chain with a beautiful red stone.

>x red stone
A gorgeous red stone. You've never seen a jewl as beautiful as this.

With your final spell you bring the wizard to his knees, defeated. "How did you…畯'" he says, falling onto his hands.
"Obstupefio!" you cry, paralyzing him. The wizard falls to the ground, his eyes the only part of his body that moves. Around his neck is a thick chain with a beautiful red stone.

* * *

>gonear vending cart
Flower Vendor
Mr. Florence has run the vending cart for as long as you've lived here.

>take wildflowers
You can't steal that! It costs a Two Coin Piece.

I beg your pardon?

>take wildflowers
You can't steal that! It costs a Two Coin Piece.

* * *

I beg your pardon?

>x vending cart
A rather nice wooden cart with metal supports. Bushels of flowers are gathered in dozens along the cart's shelves.

>x bushels
There are: wildflowers, azaleas, pink and white lilies, daffodils, irises, jasmine blossoms, marigolds, and daisies. Each dozen costs a Two Coin Piece.

>x wildflowers
A dozen different flowers bunched together.

>take wildflowers
You can't steal that! It costs a Two Coin Piece.

* * *

>gonear vending cart
Flower Vendor
Mr. Florence has run the vending cart for as long as you've lived here.

>take irises
That's hardly portable.

>take flowers
Which do you mean, Bushels of Flowers or Different Flowers?

>take bushels of flowers
That's hardly portable.

>take different flowers
That's hardly portable.

>x wildflowers
A dozen different flowers bunched together.

>take wildflowers
That's hardly portable.